11000010100000000100100100100000000001110000000001110000100001101101010000010010000011000100100100001
00001000000011001011010100100001001010001110010011001001000100100001000000001000001010111000101101100
00101101010001010000011000010000001000000110010011000001000001111101011100100001100110010010100000010
00110000100100100001001000010100010001100100110000000010000010001010010100010011101001000101001001000
00001000010100100011000010010001010001101100100100001010000000000100001001000100001010000100000100000
00000100010010001000001001010001010100011100110101000000000001000000110001000100000000001100011100100
10001010101100111101101100000000101100100110101101001110111111010110100001010100000101000100010111001
00000111010100100000000000100111110100000100000100000011110100000000000001000010001001001100100000010
01011011011001101001100101010001001000010111000001001001010000010011100000000101010101010101000000000
00100110100010000010000000100000010001000001111100000011110010110001110001010100000001000000000100000
00010100000000001100110100111110000100100000000000000000011001100001011100010010001000000101000010000
01100000010111110010000100010100000100001101100101011000110111010100010000000001001010000110000000001
01000101011100010100000000100011001110001000001000000100000100001G01111000101000010001001001000100011
00010100001110000100000000000000000000000000101111000011010111110010000101101000101010000000000010101
10001100110110001100001000000010100000001101000010011010000100000100010011100010010010000000000001100
01000000100110000011101100101000101000001101000101000000011010000010010010011001000000000000000100001
00000000001101100000000000101001110110001000100000001011000001000011010011001000100100010010110001000
10001000000110000000010100000011100000000100100000001000000101000000101100001000001010001010101001101
10001110000100000110001010000000001000111110000001000111010110010001000001111010010100010010010000011
10010000010100101110000011001001100000000000001001000101010111010001010111001100101100101011000000000
00001010000101100001000000000000000001000000100100000000100000000000100000010001000001110000000000010
10110000010001000001000100000010000010000000000110111001000001110101010011110001001000011000000100000
01000001011000000010000100010001011000001001111000010000000101000100001010101101000110111S00100001010
00101001111000001010100011011010000000000100100101000100000001001000001000000010010000010100010000000
00000100000000000010101000000001001010010000100001001100101000010000000100000011101110000000000100101
00111100001001000011100101101000001100001000101101001011000110000000110001000000001001001010000001111
10011001100000000000010111000100000000000000101000010000100000110001000000000100010100000101000000100
00000100001011010010000010001000000100010001010101010100000110001010011010110010101010000100011101000
11000000000010001100110001000000101110000011011000100101001011101010000000100001011101000110000010000
10110011000000000001101111001000100110100001000000100010000101110100000000110000010011000000001110001
10111011010000000011101110000001001010001000011010001011001011010110001111110100110000001101000001000
11010000100100011011000100011000000000000001000100001000010010001001010110110110101011000100001111100
01000011001001010001010101001010000000000000011011000001000010000101110000001001000001000110110000010
00100010001000101011000001110000110010001010101101010100001101001011000000100010000000011100100110000
00101000000100001010100010100100101001010000100011010100100000000010001000011000110000001000111101110
01100100001000000101010010100100001001011001011011101000000100000000011000101001000010000000000100001
11000010110001000100000000001100010000100100100100000100011011010100101010100000100011001110000000010
10110100000000000011100101011000000000111111010001100110010010110000000000001001100000100000010100000
00110000110000000000100100100100010010000100101000100000000100000100000001001000010010000010111000000
10011100011000100001111000010000101000001110010011001000100100010000000010000100001000001011001010100
10100000101011001000110001100100000010010100010100110000011010001010101100000111010010001011000001100
01000000000100001000000000000000010100100100001001010010000000000000010110000010000110001101000000111
10100111000001110111010100100101011010000000000000100000100100011000000011101000000010000110001000000
10000100001000100010000001100000010000011011010010110000000000011101000001101111000000001001111010010
01100000010000110100101010001100100000111000000000111000000011010100001100011000100001100000010001010
10010001010011100101000100000001001100001001101100010001000001010000101000000001011000000010110000100
11010001001000000000000000010110100000010000001000000101000111001000100100000000000110001011100000000
00011001000000010101010111010100001010000010100000010010001000110000010000100000010110000101000010100
00010110110010010110000001001010000100100100011110010010001010010100000010000110000010100100001110001
01000101010001011011001101101101011100010101000110001110000001001000101110010000011000010100011001000
10111010110011100100011000000010100000011010010100000110011001000100101001000000100000010100000110000
00100000000000001000000001111010100110010000000010111101000000011000110000000000100001100111001000000
10001001000000101000100000101010100100000100100000010101101010001000011010110000110100110000001000100
10101101000100000000100011011000010111001101001000100001010001001110100010000011100000011000001000010
10011100011001001001000000000000010010111010111001101010000001100011000100110001001100010011010000000
01010110101000010110101000011110001000001000011001001001010110010010100101000000000010001100000000000
00110000000000000000100000110000011001010100001011001000000100011010010000100010101011100100000100101
10000010010000001000100000101010101000010001100000011100010110000010010001100000000101011010010000001
10000000000001101010010001010100000100011000001000000100000010001000010100000000011100001000010010110
11000000110100000000000110000100001001110110001000001101000100110101010110101000000000000100011000000
01000001001001101100000111010001011111011001010001000100000100000100001000101100000011100000111101000
10110000000010000101010000000010000000110100010000000100010111010011110001010001010111110000001011011
00000100000100000100010101000001001101001000100000001010100000001100100000010100000100000000010001101
00000000000101110001000100111100000010001000010001001100010001100000010010000010010101000010001000001
00110110010000110101010000100001000000001001110100100101000010001001000001000010110010011011000000101
01100000001001001000010001100000010000000001000010101000000000100000111000101101000101010100000010000
00000000001000010100001010110000101100000000111011110100000101001000011101010100000001000010000001000
00010000000101011000010000000000101101001001000000010110000110101000000000001110001000110000100011000
10000001111000000000101110000001011101100001000101101011100101100100100001000010100010000000000000000
11010000000001000000111110010011001011000000000010001011000000000011000111110010001000010010001010110
01000100010110010111000000000000100000000010001111100100110000000101010010100000011000000000100101111
01011010001011100100101110000010000101110100010100011000010001000100000010010101000000011100100011110
10110001010000000111110001010010000000010001000010100000011000000110101000101100111110001001010001000
00000010011010001100110000111010000100011000101000001000000100011010000100000011101000101011111000000
10000001000000000000000001101001001010001000010010100000100100000110010100000000100100001100000100100
00100001000001000000000000000000000110010001000000010101000001000001001010100100010010000001000101100
00001000100001000100001100001000001100100101000001000011001000011101101110001110000010100101110100000
10001000000001001011000100000100101001100010101010000100100001011010000100111010001100000000110011111
00000000010000001100110010010110010000101000000010001000011110100001100000100010111001000010000111001
00100010010000010000000010010000101001100010101000010001000110001001000001011010001101001000001111000
00000110000000000011010010000000010111110010111010010111011101000001011000001100000000001100100001010
00001000101100011000011010000100001010000000000001001000000010100000011000100010100000101010001100100
11000001000100001000000000000010000100010000100100100000010000011001110100100111000100000000010011000
00110101000110110100000100010101001010001000000000001101000001001100000000011001010100010000000100010
01001000101000001000000000000000000001010111000000000101010111100100010011010000011100001001000001000
01010001100000100001000010010000000001010100010111000000100100100010110001010100000011000001000100010
00000010010000011011000010000000000100000000010000010100000001010000101001000010100010000001000001100
00100000001000100010000000011100000000100010001010100100111001000000000000001000011000010011001110000
00000000000000000100001010110100000010011001000000001000110010100100000000000001000001111000000110100
01000100000111100110000110100000010001001001001100010100000100000001001100000000000001001000010101010
00000000010101101100000010100101100100000000001011100000001000000100000010000000000000010010010100000
10000100011010000001000001000000101100100001110000111000010011101101000110010101000000100101001000110
00110010001000001000010101011101100010010000011001010101011000000000101110100000000001000001111100100
00000000011100000100101010010000010010100001011000000011010001000000011000000010000100000110000100000
01000001110010000000000010111101010000100110100000110000110000111101001101101000000110011000011000110
10000100000010000110010000111100000010000001001001001011010100000001010011000001100000000000011000001
00001100100101101000000010101000011010001010100010001001011001010010100000011100000000110000001011010
01110000000100000110000101000000100001010100110000100000010111001100000110100000011001000000001101101
00000110010101000000000000000000000101000000001000101111001000000000011000100101000100111110010010011
00111000000000010010000000100000100000010010010001001000010000001001111000000000000110000000001001000
01010001000010000000000000010000001000110010010101000001001100010100100001000001000001100000100000110
