01110100000010011011101100000010001010011001000110001100001100001000100010100000010100001111001000010
01100100001001000010010001000000100100110000101001010000100001101000011001000000111100001110001001001
01000000000101000001001011000100000100000010000011000000000000000110100111000001000000111000000000000
11000101111001100000010111100011010110000000110010110000000001100001001110101000010010001001010000010
11010001000110001010010100100100010000010101001010001000101101001101000110001110000000000000000110000
00011001000001010000100000000011000011001011000000000000101100001010000000000000110100000000011010000
10000000100000011010100100001010000100011000000111000001100011100000010000000100000001000100000000100
10010101001001000000101000100111000000010101101010010010000000010000100000110001010001010000000000000
01001101000000000011100010100000001001000110000100010000010110001101010101001010000000000101000000010
10010101110001000000000100000001111010001110011101100001001000000001100011000100010100001010000110000
10000101001000001000001000000000110000100100100000000100010011001000000001001010010011010011000101100
01000100100011010000010100000101001001001000000010011010100001010000000010110001001110011000100001001
00000010100000101010001100000000000000101100111100000001000101010001100010000110100000000001100101001
00100000001000001010110001010011000100100011000010011000010000001001000011000000100000000011010000101
01010001000000000000010111101000010101000000101011010000010000111100100000010101010000010101101001110
01000000000011100010001000001110000010000001000101000100100000001000000000000001110000011001100000010
00100010000000001100100100001010111000001000000000000001100110000010000000010001101000001010000001000
11001010000100111000100101000000010000001000010101001100110000000010000000010010010000000010010011100
00101100001001001010011000001110000101100101000100000001100100111001000001100100000100100010001101000
01000110000000110011001000000100100010110011000101010000001100100011010000100100010110000100000001010
01100110011100000001110010100000110000001010000001000010001011000010010001010101110001000000000010000
11000100111000001001111011000010100010000010010001001000000011010100001011001011000101111100011000000
00000100000001000001100100000000000000000110100100000000100100001001000111000101010001000011011101000
00100010101000000000001110000111000101010000010100000101110000100011111000000010110000100000010000010
00100000110001100110011000000000110000011000010100000110010010001000000001000000000000010100111000101
11001000001000111000001001001000010000000101111001000100001000000010000000100001000000001100000011100
00010000000011110000001100011010010111010001100101011001010110000000100100111110010100011100010010110
00010100001000110001110011100101001000001100000001010100101101011000100100000001000000100001010100000
10101000100010001010000110001111100011101110000011000100101000000000011110010101110001100010000001011
00000011100010000011010000000000011000100001100000000001110100000000100001000100010000110011101011111
01000000111100011000000010001101011001100000001101000000010000100001000100011000110111101000000010000
00000010100000001001111110100000000001110001000000010100000001010010101100100010001100001000110001010
10000000100111001011011100011100000100110011000000011001010000110010101000110000011001101110000110010
00000101111000001111001010101110101000011110101000010000010000010001010001100100011000100000000000011
10001010001101S00100011010010110000000010000000100000010101000000000100100001000000010001001001001010
00010001000000100000010000010000000000100000100000101011000000000000000000001100010000000000000001000
00000001000001000110100000110011100001000010001011000000001010000001011001000001010001100000001010100
01010010001001000011001010000000011010011100010001011000001010010100010101000000010000000000001001100
00111010011000000010000000100000111100000001000010100101001010001001000100001100010100101010000110000
10111000000111000000010000000010010010000100100001000000000010100001010100001100100000100001010100110
01100111010000100000101001000000100001000010001001100101000000110111011000110011100101011001001100000
00110000000011000111000110000000000000000101001011100000000101101100101010001001010100101000100110100
00000001100001011000000100001000010110010110000000000000100000000001000000100010001100000101100100101
00000001100010000011000101111001000001010110010000000010000001010000001010101000110100100000001010000
00000000000010001010001000011011101100000000000000000100000000100010000111000001001000001101000010001
00100010000011010111000100000001110011011000000000010001011000000000000010001010000100110000010000110
01000101000000010010000001100100001110010011010001100101010011000010000000100000110001010000001000001
10001011000000110000000000001001101010000010000100011001001001000000010111000100101100110000110000101
10110000000000000110000000000101100100001000110110101110001101000110110000000100100111100001010000100
00101010001100000010101100000000100001000001001010000011110010011000000100001110000000000000000110010
00100110011010000000100100101001000000000100010100000010110010100010000010010000000011100001001000001
10011010001010001110101010001000010000010001010001110110100001101001001000001010000101001000000010001
01010001111001001010000000000000110001000001010100000000010000000010000010000011111100100100000000010
10000000011100000001000010000100000110001000000110010001010110000000001001000011000100000100100000100
00000000001100010001010001000100100001110101110100001000000000111000000001010001000010000001000100100
11000001001100000101000000000000000000010011000100000011001000010000100001001000010001011001000010111
00111110001101110010110010001000000000001000001000000010000000011000000100000001010001011110100001001
10001000101110001000010000110000100110100001000000000001000000001010001010001000000000100110110011101
11001100101000110010000001000000011100011001010000000000011010101111100110010000001000010111011001100
00011010000001101001001010000010000000010010000000100001000000000001100000000010100000010011000110010
00000000101100000100010100100000000000100010100011000100100010100000010010100010100010100010100010000
01011000000100101010000001001000110110000101010010000000010000100001000010000110011010000010100000001
0000000000001011001000000010000100101000000101000000010110001010011010G010000010010101000001000101000
10000110100000100010100010001011000011001000001101101101101000011101010010110000100000001101100000000
00100001000000110000011001100000011010000000100111010010100010011110101000000000000100000000010100110
00100010000010110000010000010001000000000001000010101100010010010000100000000001000101010110100001001
10000010000000110000000000000011010101100000000001100000001000000001100010110010110100110010111110010
10001001001000000011000100000101000010001101000001001011000000110001101100001011001010000110101001110
10011010000000101100011011100110000100000100010000010000000000001011000000000000001001000111010000010
10100001000000000000001001000000111000000000011010110001011110011000101000000010000101010000000100001
00000001001001001000011001100101001100101010000110000011101100000000000001000100000001001110001000100
01001001001100000000101000100000110000100101110000011001011100101000000100000001000000100010110000100
00100110011111101000010000000000000000001010000001010111101001001010000101001000111011101110000001111
00000010000110111001101010100000000101010011101100000110001010100000000000000001000000000000100000100
10000100001010001010100000000100000010000000010101000000010000010000101101010001000110001100100110110
10001000110000001100000001000100000100101111110000000100100000000110000000001000100001011100000000011
00001110011000010000000010000010100001010010000110111010000000000000110100001000000100101000100100000
00110001011000001010010100000110000000000010110010110100000110011110010001001110101000100000011000001
10000100000001000011110101100110100100000001000001000011011000001101000001001000110010000100111000000
00001000000011110000110010100010000000100001001000000100000001000000000011101010001100100111100001000
01010111000100001001000001110110101000000000100100110000000011000000110010001101100000100100001110001
11010010010101010011010000000100000011010101001001001010010000011010110011000100000011100000010000001
00010011001000011110000110010001000000111100111000001010011010010000000000000000100010001010100101100
00010000001001010000010010010011011110000100010000001000011000101011000001100000010010001010001100010
01000000101101000110000000001000100100001010000000000010100100001011100010001001100100000000000000011
00001001100000110010100001110100001000010111001000101010100001110010011101000100100010010010000010101
11010100010100000100000010100001000001001000010010110000010000110101000000001010100000011000010011001
11011000000010101000000010111000010000000100000000011001111100000100001000010101000010101000010010000
01000011000001000000001010101001000001100010101001111010111000000010000001000010011000010100000010001
01011001101011001000100101010000010111000011000101000100000001000000001000010111000100010000000110000
00000100010000101000010001000000011000001110001100000010001110000000001111010001101100110000010101111
01001011010000100000010110000010010000100100001110000000010000101000000000000110011100101001111000010
10101010000100100001000000100000110010110000011010110000000001011000000100001000011001001111011100100
10110001000000000000001001111101000000000001010000110001011101100000001010100100101000100000000000100
00000000001110001010011001000001000001000000001000000010010010101110001000100100110010000110000110100
00010001100000000001001000000100001000000000100001100000001100000000010101100000000000100111001010001
10111011110110101101011010010100000000000000001100100100000100010000001101000000100001010000100111100
00000100010000100101101000101011000101000010000010100000100100110101001000001111000010010000101000000
00000001000000100000101000110001001100000000001001000000110000001000001110000100001111000000000100000
00010101000000000001001000011101010000010000100101100001100100001010000000100010101000001000000010100
01000000000000000101100100000100001000111001001001000010000010000111100001000010000000011001100001010
