10111110010110100001000101010100010110000101001010101000000000001011111100011110000010000101101000001
00100100000000000010010101000000001101001010110010010000100000000001000000010001010000010001100100000
00000100000100001011010101000000000000010000100000001101110101010000000000000110000001101000000000000
00000000000100001111000011011100110010100000000001010000000100100101011000000001110100100000000000000
10001111100001001000001000000111000000100000000011110100010000010001100011000000101100000000010000000
01010000000000000010000001100101001110000100000100000001010111010010100001000000001100001101000100111
00000000000000000000101000000011000100100010111010001100001101000011001011000000011100100000001100010
00100010011000000000111010001000000001010110000010000100110101000000011100100010100100110000101000001
00000011000000001011000100000110000100010000001100010000011101111001000001100100000011110100101001000
00110001000001011000100011001100100100001011001101001000101000000111010110000000110000000101000000001
00000000101001010000110100001000100000101010011010000010100000000000010101000100100000100111000011001
10000010101111010010111000101001110100100000001000000000000001011010000001000000000000000010000010110
10000000000001010100001010000011000100000100001011001111000010000100100101110001000001001110101110100
01100001010000000010000110100001000001010100000100100000000000010011001000100101011000010010001010000
10001100000000011000000010000010010000110000000000001010111000000000001000110011110010000100000000100
00000000001001101110100010100011010001000010001000011001101000011000011110000000000001011100000101000
00000101101100001000000100110110101000111001000010100010100101010010100000101000000100010101010010000
00110000011000010011000011000000011000000110010001000000000110100000010110000001011000110110101110011
00111010000001010000010000000110100010110100000100000000100010010000110001000000110010011100000010100
01000000000010000000010001000010100100000000100000000101010000001100010001001010000011110001000000000
00000010100100000010001001100001100000100001101000010000000000010100110010100001010001001011100000000
00101000101001110110111010011001000000010110101010001010000011001100000000001010000100100100001110000
01100000100000100011010000000000101010000011101010000100000010100000000000010001001010001010000011010
00101000110100001000000011010000111010001111010000010110000001100000111001001000000010000110000000010
01000001111010100000100001000100010000001011010010000100001010011101010000100000011000011000010101000
1100010000000000010001101001001000000000000100000000010110000010010001011000010001000100000000110000S
00000001010001100000000000001000000001100000001001100000010101000000110010000000001000100000010001011
00111010000100000001010001001100111000001110100000011000000100010000010101101100101010011001001000000
01110100010000101000001001100100100001000100000000101100110010100001000010101000000001100000010111111
00101100001010101000010100000101000001000000100001000010000010011001000000000001100000000001010100000
11000000011100001000000000000000010110000010000001010011010100100000110000001000100010001100000011000
00101001010010000000000000001011100100101001000110100000100001100100100000100110000000010110001101101
00000001010000101010110001110100100000001011000001010010010001010101010000100101000101000001100100100
01010000010010000110000000010100000000100110000000001101010100001000100101100101101000011001100010000
01001000000000000010000000100100001000011000110101101001110110000110000000011000000000100000000000010
00100010011000000110100000100011011000101011001000000001101001001000001000010100001011010001000000000
00010011010001000110011000000001010000000000100000100000010100100000000000100100100100010000100001010
11000000000000100110001011000010000100010000000000000000011000011010100000000000011110000010100000110
01000101000011100011001111010000100111110010111000000010010000000100011010000010000001001001010000000
01100001000100100100001010010000100001000000000000111000111101100000011010110010010100011010000100100
00000010100000001100001010100110010000001011000001100000000100000000100100000000010010100101011100001
11000010001001101001000101000011000111000100001110001010000011000000001000101000100100000000000000001
01100001000101010110011110001100010100000100001100110001000101001011000010100000001101010100101000001
00110000101001010110100001110000010010010000011001000001010000000110100100001001000000011010000000001
11110100001000100011001001111110000010000000000000001000011110100000110101000001011001000001000010010
10100000000000011111100000000001000000000000010000011001000110100110000000000010000010101000010000010
00011100101001110001000001011000000001100100101100100000101000000000000000100110000010110110001110101
00010100001000011000000100001100010000100000101010110001001000001111000010010000000001101101100000101
10011001010101100000011010100110100000010000100100010101101001110110010100110100100001000110010001001
01010110001000111101000100000010001000000000110101010000000001011110100110100111000110011110000011100
00101000000001001000011001000000001010010000010001001000001000000100011000010001011111000101010000000
00001000110001001000110001101010101100110010000000100111101000000110000010001011000000011000111101110
00000100011100110010000001000000000000010000001010000010100100110011011000000100100010010001001000000
00001011001010001001000010010000000100000000101011000000000000010000110000010111010010011000001001010
00001101010000000000000110000110000000010100000000010000000001000000100110000000010010101000001000100
01001100110011000000000000011000011000001000010000000010110111010001011001000000000000000100000110010
00010010011100011000000000000010001110010100010000010001000000000011000000001110100011000000011000111
00000000010111001010100000100110010100001011101000101000000000010010101000101000000000000001000001010
00011010000001110100100000011000000001011000100100100010000000001000010010110000001001010000011100100
01000000111000000000000111001010000000000101010101010000010110000001101010100000000101100111000001000
00000000010000000000011101000000001001000001110000100011000001011001001001110000000010110010010001001
10000001000010100000100000001000010000010100000001000100000110001110000001101100010000000100000110001
01100000000000001001010000100001001000101101000000000010101100001000111010100010000010000000010000000
10001100101000101100100100000011010100100000000100001011000011100011100001000100001001000000100011000
01010000000000010010001000000001001101001110000100000000000100110100000101000100000000001000000010001
01000110000001101001000110010100010100000010000100101011101110000000100011010111001000010110000100110
00000000010000001010110111011101110000010100100010000001101010111000001001100000000000001100010001100
00000000100010001000110010000101011100110000110010011001111101100101101000000101001010010001000001000
00101101000000110111000000110101000000100110001010110010100100110001100001000000000100000010000110101
00010001000000000100000100000000010101010100000000001110111001000000100001001101001001000000000011000
01000000000000011000010001000001101101001001101110000010101001100001010010100100001010001100001010001
00000000000010001001110101000001000000101100001000000010000000100011000010011010100000000000010001010
00010000000011000010100110010000000011010100110001000001001000100100100000101000000011010010110000100
00001001000000010000000010100101110001000000001000001010110100001100110010101000000010011011000010010
11000100010100000001000000000001101101010000001010000001001000001100000101110100101100100000110011100
00000101000000001011000011110000010010100100101000000100100001000101001000010001110100001010100010110
10110000110001110011000010000100100000000010010001000110000011000000001110100100010001100000100101100
00000000000000001010000000010100010100101011000001011000010000001000011000111000000010101100001000001
10100000000010010011000010000001010011000101001110100100010011000001000000000110100100000000110100110
10000100000000110010001100110010000000001000000100000010011001100101000000100100000010010001000000011
00010010000000001000001001010000011101000010100100001000000110101001010100010010000010001100010110111
10100001000111000100000110000100000000110100100000010011110101000011010111010011110010000000000010010
10000000000000000000010011010010101001000000000000010000000100000000100101000000001111001000000101010
10111000111000010010000011000000100000100001100010001000010000101110100001010001011000110110000000000
00010000001001101001010000100010011000011001010101011000000100111110000000001001100111010001000000000
110100001100100000010101010000010000011000G0100000010110001000010000000001000001001101001000000011101
11110100010011001001001101001100100010000001001000100100000000001000000001100000010100000000001000010
00010010111100011010011010000100100100110000000000000010100000110110000001010110010110010101110011000
10100010000010100100100001100010001000001010000100001000010010000000000110101001001010000000000001100
00000100100101001101000000111001000000100011010011010000100010000000000010000111100111001000010010100
01000110011001001111000000011000100000010100011010000000001100110010000101110001111101100000001010011
11010011110010100001100100000100000000100000100000110010100000001000101000010000000000101010000010000
00011000110010101000000100100110010000000000000000110010011100010000000010000000000000011100011000100
00000000100001000001011101100101000111000100100110000100001010000000001010101000001001011110011001010
00111101110011011010000101110000001011011000100000001100100100010110001000010010010000001000110011001
00011001001111011101000000001000101000100011000001001000011001000000100000010100001100000000010100011
00101001001000010000010101000100001011000101101000000010100000001001000001100001010111000000000010000
10001000100000101000000100000110000100101001000001000110101001000011000110001010000010000101000100100
00110001100010000010000000000011010000000001001101000110110000001010110111100000010110010010011101001
00110100001010110000110010000000000010010010000101000101010011001100011000001000000001101011000001011
00011000001001100010110001000101010100011001010000101010000001101010110010000010000000100001111001010
