00000110110010000010000100000100011000001100000001100110000000110101000010011000101100000000000111000
00100000000101010000010000001000000010100001010010010100010010110110000110010000010000000000101001001
01100010110010000101000000110010110001000001110000000000010000101000000010000010011010000000010010100
10000010010100000000110100001000000000000010010000110100101000100010010100000101101100010010000001100
00010000011100000000010000010101010101011100101100001000000001000010000000010100000010000001001100000
01000010010100000000011010000011001000001000011101110011110001010001000101010000010001100000100010011
10000110100100010001010001100100000001101000000100000000000001100101000010000000111101000100000000000
00000100101100001010010010000001001001001011100001000101110100101000011000100000000000000011000001010
00S10000011000001000010000001001010000101001000000000001110110000000000011000110110111101001100000101
00100000001001111000010011100000000100001000000000010001100001000000111000010100001010000011001000011
01101100010000100010100000001010100100100011000000000000100110100000010110010101000010000110001000110
01001000000010001001010000100000000000101000000000100000010001101000010111000001000011100100000010001
01000000000000001100010010101000001000100000000010000010110000010100000101001110011000101000010110100
01000001001000000000100010000001101010100011000000100010001100000000110010110000000110000000010000001
00000011001011010001001000000100000101000001101001001000000001100100000100001100000000011101101101010
10010000000000100010010100001011000100001101000000111010100000101010000000010010011010001100100000100
10100000010000000101000000100001010001010011111011000110010000010001000100010000011000011000100100000
00001010101110000111000010110101000110110101001001010010110010101110011011010101001000100011000111000
00010000011000100100100010000000110001000010010010000000000000000110001000111000001010010001100001010
11101101010101000010100010000000010000100111110001000110011110000011001001000001111000010100011111100
10001010011010000101011001001100100101100110000110001000010001110000000010001000111100001111000111000
10010001000001000010001000010010100000011010000101000000000001011000111010000000000001000010010000100
01010101100001001101111001000000000001100010010011010101110100101010100100000101100111001100111000110
00100101000100000100001010100011010111101110100000110101101010000000010101010010101010010010101000000
00100111101100010101000001101000000001010000010000000011101001000000000000110000000100010001000100100
01011100000001000101000000100000100110000011110111001101010100001100011010100000110010010000110001000
01011000110000100110000010100010001111001001000001000001010010001100000110000000000011100101100010101
10001000001001101101001000100001000110100001011000100010000010000000000000010100100100000001100101000
00101001000001110100101000000100011001010100000000100000000000000001110000000001011000000100011000110
00100100111000101010001010001010100000010000001000000000000001101000100010000110110010010000100001000
01100111000010000001010010010000000000000101100001011110100100010110011000101110000000010100010000100
00100001000001100110000101110010001010000000100011000010101110010001010000100100000001100010000000011
01001100010001101001011110100001000000100010000001001100101100100100010000000001001010000000000011100
00000010000000000010011001100010001110011100100000000110001000100010000100000001111100100000101100000
11010000001000110001011100000001000000110010101000000000000101000100100010100100100110100000000000110
00000001010001000011001000010000011010001000001001110100110000110001010000000000001000100001010011001
00000000000101010001100000000000010000010010000100000011100000001011011000000000001010000000111100001
00000000010000111111101000001100010000101110001010010011001000110001000000010010000000000101000010100
10010101000001010101100000000010111000001100010110000100010100010000001000000110011001010001000011001
00000000100000000010000110000001100000001100100010000010010000100011001100000000010000000001011101111
00101000000000000011110000000001011001000100010101100011010001000010100010000100101010000100100110001
10000011001011000000010001011011110010101010100100001100000000011010000110100001000010100000010101000
00000000010000000000010000100011000100111000000110000001010011010000001000000001100010100001000000010
00001001010000010011110001101001101001001000011000101000000001001100000100000000100100000011101000100
00011000000010000000000011101011000010000001001000000000101001000010011001011101111001110011010000010
00100000001101011000001101000100101000000100000001010000010010001010001001000010001000010101101011100
01000000000000001010100001011000000000001101010110000010100001000000100011100101010000101000000000110
00010000100000000000000000010001010000011000000001101010010001001010000010100100011110000000110100010
01001100001100000101011001100111001001000000101000000000011000010000001100000100100110010001000001010
01000110110010000000010000100000101000110000000000000010000010001111000000000000100011100000000000000
10001100000011101110110010101001101001011111000000100000001001010000000000100110111001100000000000101
00000001000011100101010000000001010000011100000111001101001111100100000000010000101001000010010011110
01000001100000000001010010001000000000110100000100000100001011001111000100100011000101000000001100000
11000001011101010101000000011000001000000001010000110001001000011101000000000100010110000101110000011
00000110010001110100110101000111001000000100100010100000000000100001110011011001000110000000010101100
11100010110001000100101101000101010000010101000000000111010010100000101000011000110001011000000001001
00011010000001010000000000100000010100000100010101100100000000100000000011100001000101001000000000110
00010001100000000010000111000000111000001100011010001000111010111000010001100001010011001000110100100
00001010101000000000000101011001010010000100010000000101010010000001110000100100010010000001010000100
01001000001010011011101011000000010001000100000111000001111000000010010111110000001010010000100000000
00010000100000000001001000000100010011100100101101100010000000000010110000000110000011001000000001101
00100011011000111100000000000001000000010000001000010010100000010000100000110000111101101000001111000
10100011010001000011011100001000010011011010000110110000000010100000011000101100000000000000010100100
10001101011110001011010000100001010010001001010100000111100000000110011000101001001010000000000010101
00100110000100101010001000100010000100111010010000101110101000000000011010110010000100011001000000010
01001000000000000010001001100001000000000000111000000110001010000001000010011011001000001000011110000
01010011101011010110100101000100001001111011010000000010111000001000010001100100101000001100110100001
00000000110001011110001111000000001000001000100001101000100000100010000000100100001010001100101001011
00010100001000100001001000000010000011000110100010100010101110010010011001011100100000100000000000110
0000000G010100101000011000000000110101000000001000000000010000011111000000010000000000000000011010000
00001000100010000011010000000001000100010011000010001000000000001101011100001001100101011000011000001
00111100010000001000100000010100011010100011100101000000000000011010000010010101000101000000010000001
00000010011011000000111000000000000000001010100000000011110000000010011000010000000000000001101011010
00000101000000101101000110000010001110000100100010011100000000101111000100100000100010100001011010101
10000000010100011000100000100000101000100101010111001111001100100000000000000000100000110001110100000
00001100001000111000000110010000000001010001100100011101000010001011000101100100001000100000000100001
00001000000000000110100000000001001001100000100110000000001001100101100010011100001001001010000010100
10101000111010101000011100010000100110011101111100000000100010100010101100010000001001010111000000111
00010100000101111000000001100110000111000110010101000100000101001010110010000001010100010000000000001
01000000110000000000000000000000100011111000001101000001000100000000001001100000010001000010000000011
00001110010001000011000110001100000100100001110000001001001001100000100010000011100000100001100111100
00000001011000000000010110000101110010101000000010010001010000000000000000000100000000001011011100111
00010110000011001100010000100101010001000100010001000010000000111010111101001100010110000001000000000
00111010111001010100000001000100100010000100010011111010000000001101000101000000100000000010001011000
00000111100000010000000110100001100010000000011000010101010001000111000010000001011010101111001110111
00000100001011001011100100010001010110001010000101001001011110010110101000000000111000010000000110000
01011111011000000000100000000000010010010000010000000010001100110000001000001001100110111000101001100
11011010001001010011010010001100100100000101011011010010000000010000101111001000000110001010000000010
10010110001000100000111110001001010100101011011111010000000000011000000100000111000000011110000000100
00000001000111010010001110100011001010000100000000010000111100010000011001000101000100010001100000000
00000100000001100101100110010001000101010000110011001110011100100000011010001111100110001100110000000
00100010001000001010001000100000000001110111100110000110000000010000001001100100010001000001100010100
11010000000011110000001000000000100000000100010001000000001010110001001000101000001010010011101000001
01001100101001000110100100010001100101011000010000000011010100100000010000010011100001101000101001001
00110010001000100110000110000100000010101010000011100101011111100010001101000000100011000001010010100
00000000101000100001010001000101000001011001010100010000110111001101001000010101101001000001100000001
00000010100001001010011010011101000111001110101100100000010001010000001000110110000010101000100001000
01000011110111100000000111010000000000001001000100000100110101110001001000001000000100010011001011000
01111010110010101100000000000111100001001010000100000100100100110101000010000000010001000110010000011
10000000000010001100011010101000100011000000100000010000000110001111001001000000000001001000010000010
00000000010000100100011000000011110001001100011000000100001100001000001010000000100010000010000010000
