00000010101010100100000101001000000000100000001001000000111110010100100010100100101010000110001001000
00010001000010011100010011000011011000101000010000100100100000000011000010011001000001000000100000001
11101010000010100010010001100100110100010000000001010000101000111110000011000000110000111001001000000
00100010100010000000000010101100100010111000010100000100010100000001010000100000010100100001100000010
10100100001011100010000011001000100010001010111000010000011010000100000010010010100110011000100010001
10000100110001100100000100001010000000100000000110000000100000000101011000000000000100100001001011010
1001011001G100000011000110100000010001000000000000010000000100100010100010010000010100101011001001000
01000011101101000000000010010001000000000001010000010101100010000000100011101011001000010000000010000
00000110000001001101100100000000010100001001101110010000110000100000011100000000100001001000000110100
10010111000100001000001000000010010000001000001001011010001000100100000000000000111001101001011001100
10110000010100000100010000000010010001010000100000000000100000110000001111000000011110100000000001000
00011000001010000000000010000001000000011101100000001000100000111100011000000000000000101001101001000
00000000010100000000101101001001100000001000001001111100111000010110000010101000000010000011000110000
00001000010000010001001010000000000000001101000100000000001010001101010111000110100000000010000000000
01010010010000001000110000001000000011001100010010010101000000001000011010100000000010001001010010000
10000110100111100000010010000000000001001000000010000001010011010100010000001010101001000000100010001
00100000010000101000011000000000000011011100000100010000010010001011100011110101001000001101011110100
00010000100010110110000110000011100110110010000000001011000000000000001001010010001000000011100101010
10000010111000010000001100000010000000000101101000010000000110001000100011110101010110000100101101011
00101101001001000110000000100010100100110100000000100010010001001101000100000101100000110011101000001
10000100011000010000100000010010000000000000000011010000110001010001000010100000010011100100000010100
01010011110010000100000000010000010001101100001000001000000100011000000000000010100001000001110000000
11101000001011010010000001001010100000110110010000101000010000001100001110010000000001101101100011010
10000001010000000001110100000000000000001110010000000100001010110000001010000000000101001111001000111
00100001001000000000001001000001000110100010101100000000000000001100000101110100001000000010100100011
00000000000001100000110011000000000100000010001010001100100000000000010010000001011011000001000111010
00100110110011000000000011000011001100000000000000010000100010101000000101000000000100000010000010010
10101101010100110010010010000000110100011001001000000100111010010110001000000000010101010011000010000
00010000000010010110000001011110110000110101100001010000111010000000000011000000100000001000001001001
00010100010001000000000010001111100011000000010110101000000000101000011000001011000000010010000100000
00111100010010010110001100001001100011001011001010001010010000011100001100000000000010000000100000010
00100111101000000111000011001010010000001010110000010001000110000010010000000011100010000100100100001
00000010000010000010001000000000110100000100001000001000111000000100000000001000001010000000001010100
00000000000010011010000000001000001000001100001000001111000001010111001010000000001110000011000000000
00101101000000110000010101010111000001000101100000000010110001000100001101010010010110001000000000010
00000000100000100100010000000000001010110001011000001000010100100001000110001000010000101010100011100
00111000100111001010110111000000000011001010101011110000000100000111010110000001010110000100000000000
11000000011100001011000001001011011100011100101100110101010000000001000010010101101000011101001001001
01100000001000010110001010010000000001000011111111000010110100011010000111000111000110000010110000000
00010000000100100000110101111000000000001000000010010001000001000100010001011001011010000010010001000
00000000110000000000000010010010001000000000010101000000000110101000000111001001000010000000100001011
00000000010000010001100010000101001010011100000001100010000001101010100000010101101000000000110010100
00000000000001000000000000000000001000010000100000001000001000000001010100000010010000100000000011001
00000001001000000000000000001011000100100100001100100001010011101100000000000100100111000000100100100
00001000101010010000011010000000000111100100011000101000001001000000000100000000100000110000000100001
01000000100000000110000000010110100000000100100001110001000101001001000100010000100001101001110001010
00000001001000000001101000010000100100110001001100001000000100010001000000101000101010001100000111000
00000000001001000100111110001011010000010100000000100100101000000000000001000000110010000000000000001
11010001000010011011000010000001100110000110100010000100000001000100110000101000000000110010001110000
00000000000011000100010011000000000001000100000000100000011111110100011100000111001000001000100001110
01101011000100000000000110000010000001001000011001000100000100011000000000100000110000111010100000000
00000000101001010100111000100100001001110010011000100001100000000000000000011001011010011110010100010
0000001000000001000010011111000010001000100000111100000001000010010000S101010110000110101100011011101
01111000000010010111100011100011010110110000100101010101000000010011010000000000110000000000101001100
10111001000101010100000100000010000000000101001000110000011010101000000000010100111001000010010100000
00111000000010000010100000010000011010001001000110010101010010111000001011011110111001100000101110010
00000000000010000000110000010100010001000000101001011011001001000000000001100001100100011000100001010
00001000100010000100011000001001100001100100000110101100000011000001000000001000011011111011011000000
00010000001000011011101001101011000001000010001100100010100101100100001010110100101010000010010001000
00111001010101110010010011101110000010001101101010010100000001001111001001110001000110011000100010010
11001110000001010010000000000011000000110000001100000001011100111000001111001010010010110101001000000
01000000100000001101001101001010110000101110010001110001010011111000001000001011100100010000000010100
01110001110010001110101001100001001010000000000001010000000000010001110010001000000000001000101001000
00001010011011000000111010011110100111010101000010100010010010000100100000010000000010100100000000010
00010000110000001110110000100000100111101000101100000001010000011001001000000000101000000011001100000
00110100000000001010101000010100000100000010010100000000000010010000010000100001000001010010000010010
00000100001000101001100000101000100000000001001011111000000000101011010000000001010100101101000000010
01001000010010000000100110010001100100000110000000000011011100010100001001000001011000101011100000100
10011010100000110010100010000100010100000101100110010001001011001100101100000010100100000000000000010
01000010000100100110000000000110000100100101101001111001000101010001000010001000101001101100000101000
00000001101010100000000101100001111000101100011100110011000100100000010100100010101010101110000110100
10000010101000000100110000001011001001010111010001100000100000000000100101001011100011000101010001010
00110000011000000000001000010000100100101000010000000100001000100001001000000000000001110000000010001
00001001010010000000010000001010000000001000000001000000000000000011101000000000110000110000111010000
00010001010000101000010001000101000101010001011011110101000001101001001100110100010100010101100000100
10100000101000011000010010010110100011001000000011100001001000100110100001000100000011001000000001010
10000001000111010010011010010100101000100000111101010000000010100001101011100000001101001000110010000
00000100011110110000001000001100000001001001100011110000100000001010010001101110010011010100001000000
00100010010001001000101111000100000001001010010000000000010010011001000100101101110010000000100001000
11010100100000001000011001000111100010000010011000010010000000001101101111000000001000010000010011000
01100001100100011010000110010010001101010010000000010000011001000000000110000000001000010000001100110
00001010000110000010000000000001000000000000110000100110000000111001010010110111010011001000101101111
00010001010000100000001000000000001011010100000000010010010000000010000000000000010010000010001010001
10110100000101100010001000010100100000100000001000000010001110110001011100100010000110000000000110110
10001010100001011011100011110001000100000000100010000010000000000100100000100011010001000000011010000
00000000001000101000000001110000000000010000000000000101010000011010000000101100101001000110000110001
10100101000111010100100001001010000101000111111100010010000000000000100000000100001000000110010010010
10011001000010001000000101011011011101011000000011000000011001001000010011101000111101110001001000011
01110100000001110001110010110000000001110000100111001000000100000010000101110000000010010100111000000
11101000101000010000100000000000111100100000001011000100010000000010010001000011010000101000100111111
01000000001000100000000010100110000111001001001001001000100001110000000001000110100010000000000000010
10000100000001111000000110010010011100010000110100001011100100100000010001000000010000000110001100001
01100110100111100100000000011101000000001100000110011000000101000000000001001011001001100110100010010
00000010010000000000000001100001001000000110000110000111000001000000000010000000000010100011010001110
10110000010000000001100010011000010000001000001011001000010010101010101000100001010001000000011000110
10111010001100000010100011000100000100000100000000000100000100010000000000000000100010110101000100100
10001010000110011010110000001011010000101100001000000011010110011101001000000001100100110000100011011
00000000010100010100001000100001001000000010110001000010001100101000011000000000010000100101001111010
11110001011010100010000000000100110101110100010100001000010011000000110100011110000000011010000011000
00001000000110010001000100000010001010010001000000110001100010011100001010001100100000110000000100000
00001001001001000000100000000100000100101000001001000000011000101110101011000100001000100000100100011
