01101100001010001000010000000001111011100000000000100101000110000010110000000010000000001010100100000
00000010000111010011100000000011010001000010011100101010100100000001001000001001011000000000000001100
01000001110011000010111011100000101000000010000000000100010010100000001000010011101000000010000101000
00001001010000110110000000111000000111010010001000000000000001100000011000100000000011100000000011000
10000010000000101000110010100101001000000001000000011000000010100011001010000000100001000111100100001
10010100000110110001010100000001000100000110000100101101100000001010110101101000000010000100001010011
01000100001110101000001100001100010010001100000011001000001001001000101001000000000100111000001110010
10101011100000001110111000100000010000000001001100010001011100010010110010100010000010010010001010010
00100000000001110010000000010001000011000000000010000000000101101011000000010011101100000000001111000
00110010000010100000000101100010100000101100110001000000000101110001000100001010000000001011000001001
00010011110110000000010100001110110000100110001011000010000100000000000000100001001101000000100000000
00100001000100101000100000000001001101000100000001000000000000000010011011100000010100100000000000000
00101000000001000100001000100000001000110000100001110101011001010100100001000000010001000100000000100
00001010100010000001111010001000100100001100000101001010001100011001000100000010010010100100001001100
00101000000000000000000110110000100100010010001100001110000001010110010000000101010110000010111100001
11000101010001001000000010000101100000011010000100010010000000001010111101000101100100101100101011001
10100000010001011011001000011000010100110001110011001010000010011000001000011011110001101101000110111
01011000010001000000001001101001000000000001000010000000100010000101000000000000000011010001101101100
00100110000010100100010000001100100100001001001000000100000100101110000000000100100100111001000011101
01100010000000000010111100011000000010010001000011111111011010110101000100000010000001000011101000110
10011010011110010100000110000010010101010111000110000110000000000010010100011000101000001000000000010
01101001101001000010010010010100100000000010100001000100001000100000001000001011010010001000010001110
10100000011100110010101101000000011100001000110100000000100001000010010011110010000000101000001000110
00000010100001000010101000010000000101010000001100000000000000000000010101000100010011000011001001000
00000010001000000000001110100100000110000110101100001110000000000100100100001000001110001000011000001
01001100010000001000100001101010000101010110010101000100000010000001001001101011001000000001110011000
10101100101000011000101000010000001010011110000100000100000000000110000001000000010100101100000000011
00010000100000101000011000000000100000111001000000000100010000100010000100000000000001001001011001001
11010100000110000101011000010100100010100000001101000001110011011000101110001000101100001010010011001
00000001011110000010111000001100000010000000010000010001000101000001000100000010001000100011101010101
00010011010010001010001000000000010010010100000001010010000001000110001000001011001100000111110100100
10001010001100001001000001001001000001100000111100000000000111101000000101001101000010101010010000001
00010000100101010000001001000010000100001000000011000000001000000010100011000100000100011110000000111
00001101000110010010000000101000000000010010100001010000001000010000000100000011000000000000000000000
00000110000011000001001100000100010000101000100000000001100000010001100000110000000000100010000101011
01001011001011010001101100001000000010100000010000001000100010011100101000000000110010000000000100011
00110100011010001011001000100010110000010000000000011000100100000010011100000100000100010100001010100
01010100000000000001011110010010100000001000101101100001001000000100111000000011010010010010000001001
00111001011111001110000000000001010011101010100010010011110010010000000100111000000100000010000010010
00100001010100110100000001000001100010110001010000110000010010000000000001010100000101010000100100000
00000011000000000100000000101000111001101000001001000110000000010010110000010000000000001000110110011
00100100111010010001110110100011000001000000010011000011000000011010100100011000001011000001010000111
10101010100101000000001100000000010000000000001010001100100000010100010111100101000010000001110101010
11010100000101110011010010100000101001110010000000000000011101000110001100000001000000000000110000000
00011001101000010100011000000100000001000001001000001000101101000001100000001001000100100100000001000
00000001100000000001010001100001010000100000001011110100000100000011001010100111000101110001000000111
10000010011100000001110000011100010000100001110001110001100000000001011001011001000100000000110010010
01110000011100010100100100100000000001100100100110110100100100001000000001000100010101000110001100000
00001010000100100000000001001100100000000000001110110100001000000010100001001100000111000000000000011
11001000001001000000100000000000000000111000001010010111000001110000110011010100001001100011000101000
01000011000000000001001000010000100000010001001100001000000000010001100000010000101100101100011010010
11101110001000001101101010110010101000001100000000000011001010100010000001001100000101001100000001100
00001000001010100000001001111100001011010011000110000111110001011100011110010000000110011100000001000
00000000000000000010000000110010001000100100000100000000101100000000000100101001000100000010101010001
01011100000010110110010101010000110100000100010010000010000111101000000000000100101011000101000000001
01010000101110100000000001011100100000101110000000101000011011010100001100100000110001000000000001100
10101001001010110000000011010100110000000100001000010011000011100100000100000101111000110101000000000
01000111000000000010110010010001000100010000100001000010100011110100000000010110000001100010010000001
00001000000001010000000001000110100100100000000110011011011010000100011001000010000000110000000011100
00100001010000000110010001000000000011010101000000000010010101000000001001011011100000000011010000001
11110100111000010001010110000000001000100000000000100010111000000000011100000010000000000000001100001
10010100100011101000001001001010100000000100101000001001100000011011000100001101100000000000001100010
01010010101001101101000100100000001010000000101100010100001100000100001010001111010000010100100101100
1010100100010010010000101101011110000000101001100000001000000000110100000000001101010S000011100101000
10001101101000000101000010001000110000101001101000000000000011010000100000110010100001001000001000010
00000000000010100001101100100011000111110000101000000010100000000011001000011100000100010001000000100
01001111011111100100001011100100100001000011001001000000000000101110010000100110000100100000011001100
10000110011010001000000000110000101000100011010010000100010011101101000100000010001000001011000000000
10000100000101011000100101000100110000000001111010100010010100100100101001000111000011101010000000000
11100100000100011000000000000011110000000100100011000011000111000101001111010100000000011001000000000
10110000111001110011000000000100000000100110000001000001000010010000100000000100101010001001000000000
00000000000010010100000000011001000000000100000100001000100000000111000000000010000101001100100001000
10000000000010001000001110000000000010101100000100100000000100010001000100001110000110010000011000100
01001010000100100000010100001001001000001010011000000000100000000100100001011001001110001011000011100
11111010000000100100010000100010000001010000000011000111001000100001010000100100110010101100000110011
00110111100001011000001000010100000000000000000000000000100111110101100001011010000000000110101110011
00010101011010010100101011110000001000101101000001001011000010000001010111010000100011000001000001010
00001000000000001011001000001000000110100000101000010001100000001100110000101010000010000001101000000
11100001000000001000100111010000000110001010011000001111000100000100110110000000000100001011110101000
00110100000000000000000000000110001000000000011000000000001101111001000001011000101000000001000010000
00000011101011000100000100000100101000000000100010100010100000101101110010001110110110010000100000100
00000000100011000001001001001000000111010100101010010001010000000001010000110000001010110011010010110
00010101000001010100000001000000000001100010010100111110011001000000011111011000001010000110001100000
10100011000001111100101011000110010011010001000001100010100000000001110000011000100001011000000000011
10010000110000100011000001001010010000010010000001000100000100000101000101000000010111010001001000001
10000000000000000000001000110010001101000011010000000011000010001001000101010100001001100011001001000
00011000001100100000010000000110000110010100000100100011000100001000101001011100001100001010101100010
00010100000100100011010101100001000011100000100010011000000110000000000000100000000000000111110000001
11100100000000010000100000000000100001001100001010101000100001011001111100010000000000100011000011110
00100100001000000100000001010001000000011000010101001001000000010000000110000100110000111110001001011
0010000000000100100000100011010000010000000000001101011101001000001010000000011000010100010110011000G
00101100100000000001110000010100000100010001011100001000000000010100000010000001010011011110000000010
01000001010001000000000011000000010100100100000011011111101001000110000000000000101010001111000001010
11111000000101010101100111011101100000010100001011100001011010000000011000000000001000101000000100100
00010100100000000101100000001001000000000011101110000000110010110100110000000001011000101001000000000
00001010000100000000010001010000000001000100100000000010001010100000000000001101001000000000000000001
10000011000000100001011000100011111000000110101001001000100000011010010000010010001101000000000000001
10010011100000010001010001011100001000010010000100001000011001011001101000001001000101001000010011001
01000000011001000000100000010100000110111001000010010000101110100010000011000001001100010000000000100
00000100101001001000001000010100000011101100000000010000010000011000000100000110001100101001010010001
00001001001100001001011010100001101110010010000000011111101000101010111001010011000110001001001001101
