100101000001000100000111010000100110100110010011111001100100100101100100001100100000011000S1100100001
00000011000000010001100011100000000000100110000010000000100011011000010100100101001000000001110111010
10000000101010001011011010000001010000001000010000110000001010010000000100010010100100100000001001110
01001001010111111000000000010000010100100000000010000100101011001010100000001101100000011110100000011
00000000100100001010100000000000001000000100000101000000101000010100011001100000000000000101110100010
10010100000101011000010101101000100101100001001001000110100000010000011100010011101000010001000000100
11110111000101100101010000110010010000000001011110001000000101111010000001000000100110000100000000000
01010000010000000100001000000100100110110000000100101000001100100001001011010000011000010000000000010
10011000000001000010000100010111000100100000011101000101000000001101010000000111010100110100000010000
10000001001000010000001100100011111000010010010110101010000001101010001000000100100000000000000001101
00001000000001100111010100110011001100011100100111111001000000011001100010000000011110100000000010001
00001000100010010000000011000001001001000001000011111111001010011000100010001000011000010011010110000
10101010000110000100101100100001000010001001011101000011001000110100010000100010101100001000010000000
00011010101101000001000001001000001000110001010001010100010010010110000101000000011000000000000100001
10000001010000000011000100110111111100010000000000111100000000000010001101000111001010101100001000000
00010010010010000001100000000100010101001100010000011010000100000000001011011000001110000001111001100
10000000110010010010000100000110000110000110100010010110001000111011100110000011011001000000000111010
10011010000000110101100100010011010110000000000010001001000101011000001000000011000000100010000011000
10100000000001010000000011000000010001000010000001100010010001001110010000000001000001100000100000100
10000010000001000000011010000011000001000101010011001001001001001100000001101010000011100000000010111
00001010000100100000000111000001010000000010000000100010100111010001001000010000010100011000000000101
00100100010011000100010000000001000111000101000001100000010010000010001001010110010000100000100011100
11101011000110011000100100001011010000001101011101011011000000010000000100000110001010000110000100110
00010101110010111101000000000100110001101001010010100011001100001001000100100000100010011000000000100
10010001000001100000001110010000000010100000110010000000110001010010000000110100001000000010001101010
11000000010000000011000010110000000010000000000001000100000000001011000110010100001101100000110010001
00000001001101000011011010001010000000001100100010000000000000000100000010000101010010100010100010000
00111010000000000010000010000100000000010000100000010100000000000001000001011000000010000101010110000
00010010000100000000001011110000100000111001000000000000000110000000000011000001001110011100000000001
00000000001000000000000000010001101000000000101001000000000001010100110001000000111000111010000010000
00101000010110001000001000000001000001110000000011110000010001010011000100000000001110000000011000010
00000011010001010001010011011100100101110001000000011111100010000000000100010100100000011000000111000
00110100000010101000011110100000011001010100010000000001001001010000000000101001101000100000010000000
10100010011000010110010000000100010011000011000000000000100110110010000000010101000001010000000010100
10001100001100001110001000101001000000001000000100G00110010010010001101111001010100000100110110000110
01110001110010100011100011010000011010000100000000010011111000000100110100000010100011000110100110000
01010110011001010001010101100010001001001010011000001010001101000000100000011001001000110000000100000
01001010001010010001001010000001100101000110000100000000001100001000100101101000101000100001000000100
01000101100000010001000010100001011000100101000101001101000100011111001000000100001110001001000000110
11100000000111100010000100000001100100000100100000000000000001011100001011100000010100110000000101010
10010001010100010000000010000001100000001010000000100001000100100000100110111000000001100000000001010
00100000100010001000000101101011010000100111000001010011000101010000001100100100001001001101010010001
01010001000100000001011000000000100010011010110100010000001000100100000001000101100010000000010111000
00000001011011110001000000000001100111011001101100100000001010100001010010001001100110000011000000011
00100101000110011000000110010100010011000000010000100010001100100010111100110110100100110000110011101
00001010100000101000001001000000100000000000100000010100000001000000101010000100010100001000100000101
01101001100010100011000000101011000101001010000000000010000100000000001000000101000001011000100100110
10100100010000001100011001100101011101111001011010000100101100011000000001000000000010100000000010000
10000000011000000000010100111001001000010000000100111010110011001000001001001000000001000000010000100
00101111000100010010100001001101000000001100100110000000100100000100101000000010000100100000001000001
10101011010000000010000000010100010100000011011000011000000110101010011000000111000000100000110100000
00011000000001001110011111100000100111000001000000000100000000011001001000000101010000000101000100010
11101000110000001110000010010000000100010100100000000110101000010000011010001101010001000101101110000
10000100001010001000010100101000100000101100010001100010110010000010000001111000000111001100010001100
10000000000101000000100001001100110010101110100010000000001000011110000011111010001100000000001000011
00110101000100110101101100011001001010100100001010000000010100000010000001000100000000100000000100000
00100000000000011010000101011000000000000001000100010100000000100000010000100001000110000100100100101
10100010101010000101000111001001011000010010000101000001000011000001101000000000101000000001000001100
01110010000001000000001001010110101101111010001100000000000000011000011000100001010001001011000001111
00000011010000011110001000000001000001100000100010010110001100100000001010010010011000111010000010000
01010010010110100011111000100110001100110010001000110010000100100100100000011000000000000100101000010
00000100110110100000110000001000100100100001100000110000110000100000001100011000000010111000001100001
10010000011001100000001010101000000000000101100000001000100000000101010110101101110010010100010100010
00010001010010100010110110000001101010011100001000110010010000011001000010000010001000000010001100011
00011001101000000101010100010111110110100001011010100110010000001001011000101000000100110011001010011
00000000010000010011000011101000010100000000110100000101110111000000001100100110000001100101010000011
11100001001001100011000010001011100011000101000001000011101101110100011000111010011000001000001001010
01101000000010010001011001111000011000000001000000001000011001000001010101000110000100011001000010010
10001000010010000000000010000000000100100000001001010001010000100010000010000001000100010000001010101
00011000000011010000000001110100000001000001011000010110000101000000101100101100110100000010000001001
00100000100000000001000100001100000010100011100000110110001010000001000100010011001000110110000010000
01101100100011001001000011101001001010110001010110100000000100110010000110100010001111111010010000100
11000001101111100010011101111000000011011000011101011110000011100000010010010010001001000100000110000
01000100010000000000000010100001011001100000101010000010011010100100000000011010011000000001110000111
00001001000000101110010010010010101010101010001110100100101100000110011001000001011100010100000111000
01000000010110000101100011010111000010011110000000100011110110110000010001010010010100000001100100010
11100101110000000010110101000000001100001010101001110100000000100010000100001011000100100101001101100
00000000000100000010000000001101000001000000100001110100011000101011100001011100000010011001011000100
11000000001010011000001001000100010000000000000110100100100100000000010000110000000000000101110111111
00000110110000101001100000100000000011001011110100010100101001001000101000110101001010101011000110010
00000010000110110101000000010010000010000000100000000100001000001011000001100100100000000010000100101
00001010100000000001101001000110000100100100001001101110000010001000010000010000000010010001111110000
00000001001000010010000010100001001000001000000000010010001001000101000110000100111001001110001101010
11011100111000000100000010000101000101100100110001110101101000001100110001001111000000000001000000100
10100010001001000100110011011100101100010011010000001000000101110010010100000000011000010100100100010
10000000010011001010010000001000001101000001000000100001001010000110000000101000100001110001010110011
01011100011110000100000100000100100001001001001000000011000010000000001001000100000010001000000000000
01000000000000000100000011001101010000110000111000000000001000001110010000100110100000001010100010001
10000010001001000000011000000100101000011000000010000000000001110000010110010001000000010011100101110
00000100010000000000001000000101000100010000101011000011001000001000101010100010111001001000000001010
10000001000110101001100010000000000111000100000001010010001001100100000000001101010000000010101010001
01000101001100000000000111000000011000010000101001000100010010011101000010000100101011000100100000000
10000000010000000000000000001010000011000001110001101011000010101000010100000001100110010011001100100
00011100100000110101000000010000100001100000110000010000011100001011101001000110000000010001000001101
00000000101011010101001000000010000100001000100100100000011001001001000101010110010011011101001001010
00011000000010000000000011000010000100000001110100000010011010000000010000000100000001100001000000100
10100000010111010111001101110000000000010001000010110000110100010101000100000101000100000000000000101
10000100001101001000001010000000010000010000000001010000011000010010110011100111101010000000000110000
10010100000110001110100011111010101110001110001011000001000011001111000011110000000100000001100001011
00100010100000010101001001100100001001000010000100101011001001000000101000000001001001000000100010001
00000001110110000110000000000100001001101001110001000000001010011100000011000100100000000100010011100
