10010001001010110110111000001100011110101000001000000111010100100101000101000101100000101001000000000
00101010000001010000000000101111000001010000000010100010000111000010001000010001010001000001000100000
00000101101100000000101111100001010111000100000001000100000011000010010010010001010110001000001010000
00100001111111000101100000000010100011111000010000000010000001000001100000100100110000000010001000011
11000010010000011000000100001101010001011100101001011101101000010100100100111010000010000100111101010
01100001000001010110100110000000000001001110000001011001000110100110001000000000001000010110000001000
01000000100001100000000110100100110110000110000110101001010000100000111110000010000010101110000000000
00001000000101000000001110000100000110111010011100100100000100011001000001011000001011001010000000100
00000000000001000000011000100001000011100101000110111100100010100000110000100101000000000010010010000
00001110100000000001100000000000010010010001000000001000111100100100000001000111100100001000010111101
00000100100100001011000011011111001000100001000001000001100010100100001001100000001001000000010000000
10001100000100001000101001000001010000101100100100000010001010100011000110000000100001101001000010010
10101001010010010000000000010100011000010101010000010000000011100001110000000001101110000111010010000
11001001000000001000000001000101001010100010001001101100111000100111000010101100011000010000001111101
01010100000000010100010010111110010001110000101010101110000001011001000000000001000000011001001000000
00001000110100000100000100001011000111000010100000101001010000100000001000101011001100000001000001101
00000000000010000001010001100000010011010000000011001000000100011010000000000000000000001000000000011
01110000110000000011000000100100001100001000001110001000110110100101001000001110001000000000100010000
00001100010110111001100000100100001000010100010001100000010010010011000110011001110100000000000000000
00001000010000000000000000010011001000001001010111000110010000000001010110011010001101001001000000000
00000000000000000010110101100000000001000101100001000000100001011001110110110001000011000001100100001
00100100100000011010011010000110000000000100000000001110100001101011000101100100001000001001110000000
1000110001000110101000000000011000011010101101000000101111001001011000101000001100000100110000000010G
10000010000001010001000000100110000000100001001000100110001000000011101010000110000010010100000000101
01010010100010000100000010111000000000110010010101001011000000010101101010100100000010000010001000111
00000010010000111100110100110010100000011010001100100000010000010000100000000000110000010000010000010
01001100011010001000010011100010110000100001000010000111100000010111100001000111000010010011011101000
10010010101100000100011110000001000100010010001000110001100000011000000000000000100000100000001000011
00010000100110000010001000110000000101000000010000000000100010110100100100100001010110010000011100010
01010011110000000000001010000111100001010000010000000000100100000000000011000010110010010000001000010
10000010101000010100100001000010000100010000000000000010000000001000000100000001100010111010111100000
10100011000001000000100000100000000000000011100010001010000001110000011010000110100011000010001010010
01101011011011101101010000000000010000000000110001000100001000100011000100101000011010111000000110101
10000000001111010101010000010010000010010000010111010001100100011100100100011010100010001110010011000
00001001000001111010100000000010100000110100100000000100110100000100000000000010000000000000100000011
01000000010100000100110000110000000000000001000010000000100110100010100110001001100101010010110100000
10101000011000111000000001100001000000001000001011001000000000100010000010100000011000000001101000000
01100101000010000000001110001000110010100011011011010000010010110101100000000000000001101011010010110
01001100001001010001000101000000100110001010000000110000000000010110110100001000100000011011010000011
00100001001101100001000001110100010000100000000000000100100001011001001110000000011001000010000010001
01000100010000100110011000100010000110000011001010101000100011000010110101010110001000101010001000100
10010000110001010001000001100011110100000011110001011100001000001000110010000000000101000011011110100
00100101000000000000100000001100001001000011000001110001000001000000011010000000000001000100100010001
10000000000100011000000010101001000001001001001000100001010000010010100100000001000000100000110111000
00000000000100010110001100000100001100110000110101000001011000110000101100010001001010011110110010010
00001111011000010010010001010000100000010000010000001000001000010110000001000111010100100000000010000
01000100011001001111001000100001011100000000101001000000011010000001000000000000000010000001001011001
01000001011000000100001000000100011001100100000000011100000000000100011010001001010000010000001000010
01101100011000100101100101010010001000101001001100000000110001111011010000000001000001100000100011001
01000010000010000001001011100110111000000000100001110100100100100111101001001101000010010010000001110
01000000000001100000100000100000000000100000000000100001000101011101010001101011011100001100000000010
00101110001000010011100100001000100000000010010000010100100000000010000101110100001000010000010000001
00100100000101000000011100000101001011010000001010000111101100001100001001101000001000000101100001011
00001101010110000010110100001000001000000110000000001001110011000001000010010100011100000100010000000
01001100010111001001001110101000010010000010001010000001001000000100011010011000000110000011000000100
01101010000101001001100010101011010001100000000010100011101101010000111011000000000100001010000000001
00101011010111000001100100001001100010000001000010100100001000100011010001010101100001000000000001100
00000000010001000010101101001000100110100100000100011101000101010101000110000011000000100001001000001
01101001000001110101010110001010010001001001000101110001000001010000001010000000100001100100101011010
10000000100100010100000000010100001001001001010000010000101100000100000000000100010000000010000010100
10001100000000000001000001000001001000010100110010100000010000110000000000100000000000000011010000110
10100001100111000010000101101110100000000000001010001001000011011010100000010000100100110010001000000
00010001000011011000000011000011000101000000100010101000000100100000000011110000010001000011000010000
00000000000000010100101010100010011110110010000100011000100010100110010000001000000001000001010110010
01101001100011110010000010000100000100000100011010100110000101100000000000010000010001100010000000101
01010000000010001000010000100000000000001101101010010001001001001000001110010000001011000000110110001
10010000100000010000010000100001000001010000110011100000100000000001000011001110000101101000001000110
00000111011000010001101000000000001010000000010000000000010100010010100000001000000000100000011000010
10111110100010000010000100000010000111000001010000101000110100110000000101000100001100001011000000000
01000001000000001010100111010000101000100100101100110101010010010001110100010000101001000011001110010
10001001101100000100011000000000000010000001001000001001000100001110101000000100000000010000110001100
10000001000001000100000100100010001000000100000011001001011100000110000000101000000111010110000101011
00000000010100101100100000101100000011010110011000110000100100010100010100001000000101010011000010000
01000001000000100001001100000100000010010100100011000110000000001001001000000100000011010000001101000
00000001000000100001111101100000001100000000001000000100001000000110011101000101110000001100010000100
00110100000110010011000000000110000010001100000000100000000011000010001000010000100001111100100001101
00010101010000000001100001110011111100101001101001100000010001000100110101011000000000011110100000000
00100111110100000111111011001000010101000000000001000000000111100001011110000000000000000000000001010
00000000100010011100000101010110010000110100001010111000000000000011001000010000100000110100100001001
01000001000000001000111010010101000010100001100110010010000100000011000000000010000010000001100010100
00100010010000110110100001010000000011000101011000110011000000010010001000100011000000000000111000001
00001101110000100010001100001100100100101101111100001010010000101001000010011100110000100000000101001
01100001110000001100110001000000010100000011111000100100000000000010110000011100000000010000000100000
01001000010001100010010000010101000101101010110000010010001010000000001000001010100111000000000000000
11101001001000000101110000000001101001001000000110100000001011000010100011100000001010011001011101100
11111011011000001110000001101000100000100010000000000100001000010100000000001010011001010110110000010
00001000001001100010100010000101100000011100101001010000111001000000101111000001010101011010000000110
00001011110000101100100011001100000110011010000011011110110011110000010000010111000001000000000101000
00001000011100100000110000101010000000110001010001001001000100001000100010000100011000111000010000000
00001000000110100000100010000000001100010001101111001110100100000001000000000000001000001001110000101
10000000001000001011100100010000000100000001100100101000000001010101010000001111000001011110100101100
00000100100001011101100101000100000000001110010000000010000100100001101100100000110000000000000101000
01000001100110000001000100000010000000000000001001100000010010111101000111000101000111010001010101010
0000010100110100000001S000000000110100010010010001010010101000000100010100000100000000010000001001001
10001011000001000000100010100100000010110011000000001010100000011001001101011100010010001100000111000
00100010000001100010011000100000000001100001000000101100010000100000000001000001001000000100110110110
10000101000010000101000000010001000100101100010010000010110001000011000000010001001000000000010110000
10011010000001000110100000100100000000000000100100000000100000001000000100000000000100010001000000000
00000001011010010001001101100001110001001000010001010101001000010100001010000110100100010010000100001
01100110001100011000000100000000000100000001011100100000100010001110000100000000011010001010100001001
00000001101001001000010100001001001110100000001000011001100100010101100100001100010001011110001010000
