01001101101000000000100000110000011010111000000100000010001001000111000000100010000000101011000000100
00000100100000000110100000010000000100000001000010010010000001000001000111000000110000001000000101000
10001111000000100010101010100010001010100101000000110111001010001000010000001000100010001101101101010
00100110001011001000011100100010101100010001010000100000101000101001000111100000111011000001001110001
00000100000001100100100000000000100001011111100000100010110101000001000010010010000001000101000000000
10001100001001100001011100010000001000101100000001100000000010110001001100011101000000000010100000010
11000110110010011000000000010100010011100000100001100010110000000010000010010101000011000000101000011
10100000100010100110000000010101000000111000000110101000100010000001001000100000000000010010010000000
01001010100000110100101000100000011100011001100000110011000100101000010011010000010000000010001100100
00010110100100001000100100110000000100010100000010110001100000111000000100010010100010101100000001000
01101001010110001010001001101010101100000010010100100001000010101000010110000000100000000000010010011
01001101001001000101000000011001001000100111000100000000000000000100100100010000100000101001011001101
11000010110001001000000110100010000010000000100100011010000000000000001000000010111100001001011000110
00000001100000010000001011000101111001000001000000010101011000000001000000011011000000001000010110101
10001000010101000000110100100100101001100010000000100000100101100100110010001000000000000010110000000
10001110110000000100100000110001000000000001000101100100000000110111001010010011110101100000100000110
00100000010011010000010000000010001000010100001110000110001001011001011111001001011010000000000000000
01110000100001000010000010100001010000001001001001001100000000010100100000000000000110000000100001001
10100110000000000000000110010000010100010011110001100000000010100000000110000110010010001100100100010
10000011101000100011000001000001000001001000100000001100000010000100000001000000000000000000010000000
00000100000110000100110011000110000011001100010100010100110101000101000101000001000010000100000000100
00010000110000000000011001110111100010000011011001000011001000101000010000101000000000000000110111110
10010000110000000010000000000010110000000001100010000011000100000101011100001000001000000000000001101
00000000000000001100000000100000000010100000100001000000000000101010001000100010001011000000000000000
00001001000010000000000000000001001000101000100011010001101011100001000000001111001001000000000000100
10100110101011010001110000000010010001001010100000010010010000000000000010000000010000101100010010001
00010000000110000001100011100100000000000000001011000100110000101000001000000101000110100000000010110
00000000101000110010000010110000000100101000010100000010011011000010100100000101111000000110100001011
11000011010110011001000010110100010010000011101101000100000001000000110001000010110100001000010000000
00010010001000000100001110000101000111011010011010100100000010010010000000000000010110010011000100100
00100000101101011000101000100010010110100001010000001100010001000111001001010101000000110010010001001
00001100100000001010000000100001111010101000100001000001110000110010010101000000010100100100000101010
00110000110000000110001001000010101000000100000000001001101100000010010101000110000110010000000000000
11011000100000100001000000001000000110100001100010100001010001100000000001010100001000000100100101001
11101011100111001110001101000110110110101101001101001000100001010010000110110000000000000100000001000
10101000101000000010001000010000100010010101100000011101000000010001111010000000000010000110100000101
00001000001000101101100001100000001000000011000000111101000110001111000010000010110001010000001001011
00000111000011000001001100000010100010000000101000000010101001000101001100001110011000000000001000100
00001000010000010001110100010000110011000000001010010100011000001000000000100001110010100011000001010
11001101010000000100101110100000000001001010011000000000001011000011000000001001000000100000001000000
00001000000000011000000001101000010010101000101101010111000110110100010000100100010001011000110010110
00000100001011101110010000001100100010010000001001001001110110010001000000001110001001000110100000000
00100000001101000001010000000100101000001001001001001011110101000001100001000100000010111001000100000
00000000000110000000001101001001000100001000010100001101000100000000101000000100001100001010001110000
00000000000010001001011101001000111010101100100000100000000111100011000000001010011101001010110000000
00101000011111000001000100001101000001000101110010101000111100111000010001010111000101000110100000000
01100000011000100011100000010100001000001001100010000000000111000000000011010100000010100000011000100
10101000011000000000010001011000000100010100100001100110001010010100001110110100000101000010001001000
00001011000010001000101010010001000100000000000100000000110001000001100000000000000011101001000001010
00001010101100100000000000100000000000000000100000000101101000010000000000000000000110011100001010000
00011000101100100000000001000000000110000000100100110001011000001011001100101000001010011000101010000
00000010000010111001001101100010100110101000011010000100010101110000101000000000000000000101100111100
01101001000000011000000100100000001000001000011000001010000000001000000101110000000010001100000001000
00000000000000100010000000000100011101010100000000100010111110000000001000011000001001000100000000000
00000011011000000000010100100101000010010101000000100000100100000000010001010000010010101010000100001
00010100010100101000100000001000000100010000010000000001011001000000000000001000100100001001000010000
00110000010101011101000000000000011000001100100000001010100000100101001000011010110100100000100010111
01110010001000000100101010000010011001100001001000001100000001001110000000000000000101011010001001010
01000000000001010110110001000000101010000000101010010000001001010010001010001011100101000001111000110
10000001100100100111011000000010000010000110010101000000100000000000001011011000111001001000000100011
01100000001100000001111000101000110000000000010110001000010001010010010100110011100001010101001000001
10000001001100100100101010000100010001010011100000111110100100100000000110001000100000000101000011011
00011110001100000001000101000000100110001000001111000101111000001001101000000001000001000001000000111
110000000000001110010000101000110001100100011000100100010100001101011010001000000110000010000G0101101
00000001110100001100000011000010010000010111101000010100001000010000100000010000100000000000000010100
00100110000100000000000100010000100001010001101010000010100001000001110010110010100011000011011000010
00000110010100010001001010100110100000101010000000000000000001100000000100000001010101100011111000101
00011011000010000000100101001001100000001100000100010000000011100000001110100000011100001011000010100
00001001011000101100000110000011000010000010010100100100001001000101001000010100100010010000010000001
00000010011011000001000101100010000001001010010001001001100010000001101010101000000010000000110100000
01000000011101010011001001000010000100100010000100000001000000111100011000100110001100000000100111010
00100110001000100001000100100010010011100100010000010000000001101010000001110000100010000000010100010
00010100000000000000000100000000110000111000001100000000001000010010110010100000010000000100011000100
00010011101000000010100001011110011110000000110000000001101010001000010101000000010111010010101100001
01000100010100100001100001000111000011100010000000000000000000000011001111000100010011000001100011000
01001000111001001010100000000010000000100110100010101000001011000000000101000000100000100011101000000
00000000100000010110000000110000000000000001010111001100111001000011001010111010000101000010001000100
00011100001000000001000000100100110100001000001000011000100110000000001000000000000001001000100101000
00000001100100010000100001000100011001110000010000010100011000001111000000100000001001001011000001000
00000110000010100000010100000100000000000000000100100000001000000000000100000100000000001110100000110
00001000010010011111011011110110100100000001000001110000101001001110011100110101101001110110001001001
00110000101010100101010010010100000000000100100100010011000000100001010001010100010100000100100010001
01000110110001101100000101000101000011000110110111001001100011000000001010000001010111010001000000001
11100101010011011001001000110000001100100110001000100000001000000101110010010010000011010010000000110
00101001000010001111101000000110010110100110000010100010110100000000010000100011000010000010000011001
00101101000001000110100000100010101000001101100001001000010100100011110101000100000000000011000100010
01010010101100000100001000000001000001100010001110000110100100001010011100010010101010000010000110011
10000000001000000011001101011001000110001001000000101001000010001011010010000001000010000010010010111
00010010100011001000011010101100111010010001010010001010000010000100001110000100101110001000010110010
01010100100111000010110100000001100001110011100011011001011001110100100000011010010001001010000000000
01001000111001010011101101100100101000000100010000010000001000010001000010000010110000100000000010001
00110001000100100000001100000000110111001101000010100100010000000000101101000001100110100101001000010
00010000011010010100001001111000000010000001010000010000000010100001100000011010100100010001110011000
00010010110010000100100000100100101001010011000000110001000011110000000011100001110001000000000000000
110100000000011100100000010001110000000S0100100010001000101100010010000011011010000001000101000000000
11001010000010000010001001011000100010101000101010000010000000100101000010110000000000101110010000110
00100110100001101000100000000100001000001000000100100001100000010011011000000111000010010111001000000
10000000110011100010011011001100000001000000100010111100000000101010000000000101110001000000111011000
01111010111000100000000011000110000000010000000111001000011101111011000001001010010000000010010010000
11000000011011100001000100000101010010100010000110000010000000111011001011101011000000001100000100010
00001111001000001011000011011000001100111000100110000011100000000010000000100100111100010000010100110
