00000010000000001011011000000010000010000011101010000001001100100100000100111001000100000000010001010
00111010001001000000000000101001000010100011110010100101001100010010100101101011000100000110100100101
01000000000000101101000010000100001011110101000010000110000010110110100000000100000000110000001000000
00001101000011011001000000100000000100001000110000100110000011010011000000011111101001100110100000100
11011111010000110101100100110111101101001010000011001000011010000001110001011000000000110000100010000
10001100000000001110001000100010011010000000001000001001110000000000001001001010000100100100010010100
00000000001101001001000001100001000000010110010100010000001000100101010001001100001010001001001100000
11000001000101000010010011000000101010110101000000100011000000000110000010000000001010100000101000100
01101000000000010000000010000010100110000000100100000110001001000000000001101110100100101000000110100
01001000101000111000010001000000010100011000000100000000000010000000000100000010110000000101000100100
10100000000100111010010100001000000100000101111110000000010000110000010011110111000000100000000010111
00001000001000001010011010110110000110101110010000000000000001100010010100100100000001100000100100100
00001000001010000010000110100000010001110100000000011001110001000000100100100100101010010100001100001
00011001101000011100010000000011010100001001000000001110000101000000000010000000000010000000110100011
10000001010000000001111010010000010010100000111000001000000111000000010000001000001000010010101000011
00010000100101000000000111100110101010100000000100010001101000100011000000000100101001101010010001111
000000001001100000010000000110001000010000100010S0000010001000000000001000010011110000000100101010000
00110110010000000000100100100011110000101011010111010000001110101000000101010000001101101101000100000
00111010000010000010011000000001000000110001000010101000000011000010000110000000000000010100001001011
10101010111100101000001110011100000010010000001100000110000011000000000101001100110111000101010010010
00000100001100010000000000101000110001000111100001100000000001100000010000100010000000001000000000001
00110001000101111100000000000000010000101000010001001001000001100000111101000011010000100110001100000
11100010000000100000010001000000000000100000010000000010010000101000100011000101110000000000000010111
00000111100100111000000010010010100110001001101100011000000110001100011010100010101000010010010000101
10111100010110000011000000100000010000010000001101100000010000100011000000000110010000010000100000100
00000100010010000011000001001000100100000000001101110100010100110010010010010111100010000000110000010
01000000101001100001010100010010101000100001000100010000111001010010100010000100010000110010101110101
00010000110101000000000110010000000010000100001001010001110000101001000010001100000000011110010100000
00101000111000001001011000100100000010000110001010010000101001100001000000110010000000110010010000010
00000001000101010100000101000100001000100000000100111000000111100001000101010101001111100010001001000
00010001010001000110010001101100000010000001100111000000100100101000100101000000100101101010000011111
11010101000001010000010000110011000010000001101000000010001101101111001011000010011000000000000000110
10111000010011101000100100100001100000100000000010000001100000000001000011001011100000001011000110001
00111001010100000010011000010011101010000101101011001000000010110000001001010010001000110000000011000
11000000000001100000000010100001000000001000000010000100000000111001010100010001100001000100000000000
11011010111100011000001010000110011001000000011000001110100010011010010000100010001010010010000010001
010010000010011010000000100111G0100010100000000001001000001000111010010000101010001111001100000000001
00101100000110011000010001000011000000000011011000001100001100000000101010001111011010000101010100100
01010110010111011000010011000000000000001000100000000000001000000010000100010001010000000101000100100
01000010110011010010110000000011000110000010001000010100100100000001100010000000100001111100011000110
00010000001000010101110001000000001011001000010100010011010110000010001010100000000001010000001000000
01000000000001000101100010111110000010000110010010010000001000000110000010001100000010001010000100110
01000001100000111100100000000101101000000001000100010110000101000111101011001100010101101000100110000
01000000100010100000110000001001000100100001100000110100001010001010111001011000000000100000100100100
00100000000000100011100000101110101001100000000001010010101000010001100010101000001000000010000000001
01001000000101111011000100011100101011000010010101010000001000100000000000011000000100010000000110101
01000000000001100010110010010110111110000010100000000001000100110001110000000001000101001101011011001
11000100010100110000100000101011000010010100101000000001001101000001000010100100100001000000000000000
10000011100001011010010000000000001011100000010000000010010010010001110010100000101010011000010000000
01101000010000001010010110100100101101000010000110000001000000101111000000000110001111000101111100001
01000000011101011000110001000000000000000100001010000100011100001000101000001000010110010010000010010
00001011101010010010101000100001110101110001000010101010000010011101000001110010100000110110100010011
00100011010101100011100000001000000110110101100000001000100011000110100010100101000001000000000110000
10000101000000101001001000000000000010010000100100000000000100010001101010000000000011000000000001010
00101011100010101100000000101001010001100010010110010100110010000000000101000100010000101100110101000
10000100101011011011010010000010010010100010000000011100010100100100000001000001011101010011100000100
00000000000000000000000000000010010001111011000000111001000000110010000000100010100000000010110011000
11000000110111010100001100000010000110100101000101010001001100000000110010011000000000010011001000101
01000000000010100000000001000000000110101001111100000000000001010010000000000011000011011011100000010
10000010001000010000000100000100011000110101101000011100110000000111100010100001010110000000011100010
11010000000000110001000101000100000010100110000111000011110100000001000100000000001000011010101000011
00001000110000110101010100010010101000001110101000100010100000000010000000000110001000000010100000000
00000010001000100000001000000000010100100001001011011001000001000000000101001000000110001001110001010
00010011100100000001000110010100000100000000001001110010000000010011010010010000000100100100100000000
11110000000000001010010010101000000001000000001001010000001101010100100111000100000000100000000100111
01010000010110010100000000101010000010100001100000001110011101000001000110000010000001000010100000100
00000000000000000000011100000010001010101100001001111110110100100100100000000011010000101100010011001
11011110000001100011000000101001000001010000000100000100011000101010000011011000110110010001000100001
01010001011000000001000000110000001001000001011001000000101100011010001000111000101101000000001000000
00001000101000100011010000000010011000010010000010001000010010000011001000001100001010010000001101001
00000101100011000100011111011110000001110010000101101111000011000011100011001011011000110011011000010
00000100010100000110010111001001100110100000010010100000010100101110001100000010010100000000000000000
01110010110000000111101010010001000000100111000101110101011000000001000001110000100010000000100101001
11001101001000000001001001001100001100010000100000101001010100101100011100100010000100000000010000011
00000111101000000011011011100100010000000000000010001000010010001000100001001011010010000000100000101
10100111101000010000010001100010000001100010011111011110000001000100000011001010100000000100010000110
00000011100100000000010000000111000000100001101000010110110011000010000011100100101001000101001101000
00101000010010010101001010001100001110100100000110101000101000010000100000000000010001001011010000000
01101000000100001000010000100001001100000110001011001001110010010000110110110110001110100000110000000
11001110000100010010101101000010000000000100111000000011001101000100001001000001100000101010100010110
01000110000010010100000010110000011010100010100010010000100000010111000100001000000100011011000100000
10000100100000001010000000001100101000100100100001111110000000010001010100000110101100000010100000110
01001010001011111001001111000010000111110011000010000101111001101000011111100000000100100010010001001
01100000000000010000100011010000000000001000100000010000101000000000010001100010101010101010001010001
11100010011100000101011101011000000110000010000000101010101100110000000100010001100000100010010110111
00000001011000010100010110000000100010011111100110000001000111100110100010101000110000000001000000000
01000011000000010100010100000001010010001100000100000001000100000110010001011100100001100000000000100
10101000001100011001010001000001010000100001000100100010001000101010001001001100100000000000100001000
01000011011001000000010110000010010000111101010101001001011000001010100001001000001001110100000100001
00000100000001100010001001010010011001101010110000110000100111011001100100001001000100010111000000000
11000000010000110000000101110000110100100111010000110101101001000001001100000000001001101100000111000
00100001001100000100000100001011100100000000000001000100000001110000101011010000000010000110000000111
00000101000000010000100100100001000001101111000000001000000000010101001110010010010001100000011100000
10100010001000010000000000001101100100000000000000110000001011000111001100000100100010110100000011101
11100010010001100100000101101000011100100000000100011101001001000000110000000010011000000010100000000
10000001101010000010101000010000010000001000001101001001000000111000000000000100101001000000000001110
00010111010110001101010111100000110110011011000000110001010010010000000001010000000010010000000000000
00100101000101001000000001010010011010010000010001000010101000001000000001100010010001010000000000100
00100100100000010000110010101000100000010000100010000010100100001000000010100000001001001101001000000
00010110001001010010010001010010000000010101010000000000000101000110000100000000001110000101001100110
00000001000101000000000010010100100001001110000000000100000100010001011000010000010011101000010011100
