01101101000100100001001100001011000100101110001001000000000100001000100001001101000000000010001000010
00100000110001001100010000000001111011010101010100100000000000010000000111000110011010000100010101001
10100010010001000000110000000000001000010010001100000110000000011111010001001010011000100000000001000
00000000110000000100000000010001000100000000111111101001011100010001010000100000110110001000001101010
00011010010100111001010011000000100000001000000010000100010011000001100111000000010101000100010001010
11100000100001111010001001000110100001000000010011011001001000000010011000101000000110001100010000000
00011011110000000100000000101000011100000001110101100000000000101000100001100001011010000101100010110
00100000010101000000110001001010010011000110010010000000000110110010110000001000100100000010001010100
11000010000001110001000000001000001000011110000100000010000001100000000000000101100001001100010110011
10010000001000010000000011000010011111000000010111000101101010100101000101000010001001100101100011011
11001100000100000100000010111100010000010000001000000011000010000000100100101001100110000101010000000
00001101010010000000111000001000000001000000000010110011100000010100110010001001110000100000000000100
00011000000000010011110000001001000100000101001000100010000001000000001100000001110101110001000100101
11101010001000101000000111001001010100100001000000000000100000000001010000001000110011000111011001100
00000100000000100010100100100010100010000000000100000001101000010010100000100000000000000000011011101
00000010001000010010110100110100010010000001100110000000000100101000010001000001100011001100011101000
10001000010000100000000000010010101001000001000000000000101010011000001100001100000110001110100010000
11100100000100000011001000001000000101000000101001010000001001000100010101000000110000100010000001001
01110010000001001010110101010001001000000010001001001001000001001000001000100110000100000011010001101
10010001100000001010000100000000100010011101100110001000110111000100100000000000001000000010010011100
10101100000000001100000010100100000000000100001000000000110011000000000000000001010000001001000000111
000011000001001100100010110001000000100001001000000000101000100001010000000000000100110000G0000000101
00000100000000011010000000110000111000000101101110000000111100110101000000000011111011100000110000000
10111010100101011101000001000000110001001000101001011100000000010100000000000100000010001001011101000
10101010001100100000000000100111010001000101100010000000101000100100001000000000000000000110101011000
01001001001000001010100000000000000101001000101001000001000110001000010000100100000000000001001011011
10000000010001001110000000000001000101101101110011100000000100011100001000000000011000001000101100010
10100000001010110101000011100001111010000001010001100000110000000000000000100010010011001001100000010
00000001000010000000110100000000000000000000000010000110000000100000010101011011000100100110010000101
0100000000011001000000010001010100000000100000000000001110110000000000001011100010010000101010010S111
00000000011001010010000010011010011100000000010000111001010010000100101101101000000101000110001011100
00100001100001000001011000001000101000000000001001100000000100100010111000000000010110001000011000111
00110100101110100000010010001000010010000001010011000011000011001001100000101100101100110000011000110
00000001000110010101101111000011100110000001100001000001001011010010011010101000010001000010011111100
00100011100001000100010000000001010000000001100000000010000000101000001010111010000000010001000001100
10101100000001110000000110000001101000110010100010000001101000000000110100000011110010100011011110000
00101100000001011001100101001101100010000101001000111000100011000101000000000000011110001011101000000
00001000000111110010000010000001000001101000000000111000000000010001000011000010001100010000010000001
01000000011000000000000010111001100000000010001010111000000010001001010000000000010101011100011000110
00000000001010000011000000100000000101100010001100100000100110010010100000000000110000100101000110011
00110000011100100010000100000010001100001011000110001000100001010010010100000000101110011010000001001
00000000011110110000001000010010101000010100010100000010000011000010101000101001101000010010001010000
10000000000100000010001101000100011000110011000000000000001010001101000100000011000011010000111100001
10001100000000111010000111001010100000010011101001000010101100010101100100001001010000000111101000110
00001101000111000010000001100000010000000010000001000000011111100000110111111100000000100100010000101
01000000100110000100010001100010000001000110100010001000000010010001100100001000000100000010110100010
00001100110000000100110010000010000100001000000010000100010101001001000010011001100100001000000011100
11100111110001010000110111011001000100101000101001000110010000011011001100101001011101110001010010000
00000001111110111000000101000000010011000001001111100100110000000000010000100010010011100000001000011
00000000001101101001010101001000011000000001000000100100000000000100100100100011001000101000010111111
01010010000000101000100100011101000101100000001000101001001010010101000010100010000000000000010000000
00010001000000100100111100001100000101010000010010000000010101000000100000010000110111100000001010000
01110000001001000001100000000101100001100000010100000000001000000110011000000000000000000010010110010
00010010000000000000010010010000000000001000100100011000000110000100000010000000101011000100100001011
11000000100001001000001000000000010000000000000100000000010001010000000101011101010000000001101010010
00000100000100010000010000010000001000011101000000100001111001010001000001000000100100110111001000000
00100001111011000001000111100000100000100000000010101000001011010000000001001100000010001000001000001
10000001001000000000000100100010000000010100000000100110000100110000010000100000010100001000011010101
00000001001000000101001010000000000000000000000000100001000001000000100000101001011000110101010100011
10101000110111110001101010010000010000000010000000010101000100000001100000100000110000001000110100100
11000100001011110000011000100101000000100010100000100001001011010000000100011010000000010001101000011
00110100001110001101010101000000010000100001101100010010001100001110010001110100001011100000001000000
00010100001110101011000000001100110000111101101011110001001010000101001010001000111000001000001100000
00010010100000001111000011010110100001000000100100100000111000010001000010100010011001000001000100010
00001110000100100011000000000001100000000001100000001010100000100101100000000010001000001101000010010
10000010000100001110000010000010010010100011110001011100100100010011111001001010100110100100000100000
00000001001000011010101100010000101000000011101000001110011001000001101011000110010111100000101110000
10010110000010000000000100010001000000001001010100001101000100100000001001101000001100001001110100111
00001001000100111111000110011100100101010111010100001000000000000010000001000000000000010001001011010
00101000010000100010100001000000111010100010110001110000000101001010001000001000000001011001000000100
00100001100000101010011001010010000010100010101000001011011000010000101011100010000000000000001010010
10000001010101010100100110010000001001110100010000000000000000001000010011000000110100000001000100011
00101001111000001100100010000000001000001001000001000010110001010100000001000100010100001100000010100
00110001000000111101001110010010010011101010000000100110000100000000000000001010110000000000110100100
00101101000000000100000110001010010000100011000101110010001100001010000000000100001001000101100001111
00001100001010100011000111001100000001000110001000001000000000010101101000111010010100010000000010110
01000001100001001010000010101010011100000000001000000001000000010000000100000000101010101000000100100
10010101100000011101000010000000000000100110001001100001000010000110000001001000000000011011000101000
00100101000000001100010011101100001001000110000000010000111000001010000001010100001011000000110000000
01000100000010100000110000001111000001000000000000000000000000011000000000100110010001000001000000001
01100100100110010100011011100000010100010000001010000001000000110010011000011011011010110010010000001
00010101000010010101010110100000010100100101000011101010101001000010011100100101000000101000100001000
00100100010000010101010110000010010010011101110000100000100000011000001010000101010100100100011000001
10100111011101100001010000110000100000011010001000010010010100010010101000000000000100101001100000000
10110001100011000101100000000001000000100001010100100010100000010000110100000010000110000010010001011
01100100110010100010000011101000001100100110100000000001001001001000110000110010001000001000001000011
00100001000100100110001101100100000000101000010001000000000100001001011000000111110000000001101000100
01001110001001001001001111101001000000001101110000100000000100000010100010000000101111001000100100010
11010000100000010000010001011000010000111100000101010100001110010101001100000100000011110001000000000
00000101001000101010001000000010001101000001001000000110101000010010000011010000100000010000101010000
01001010011000100010010000010000100100000000010100100000001000010001100000011000000000010010010010010
11001000110000001000000011011000101110000010001100000010001011000000010000000001000101000000001101011
10010000001011101001000001000001100000000001000010100100101101001100100000000000000000110000001100010
00110100110000000000000001100001000000010100010001001000100100110110110001000001000100000000111001000
00000111000001000001100000000101000000010001010100100101000000011101011000000000111101101001001110010
00001010001010000000100000100010000100001010000100000000010000100101010011000001011000000100001000000
10111000011010001000110010100100011000000000000001011010100100000010000100100000000000100000001100000
10001000001000000010110000101011000010111010010011000011000000101000000111000110010100000010001001000
01000000110000000010000101001001000010011101000011111010100000001001110100000100000001100000000000010
01000100000010000100111100001110000000010001011100010001011100001010111011000000001011000101010000101
01000010110100000100000000000100000000100100110100100110100000011000100000000010000001011000101000000
