00000000010011001001100000100000011000010000110000010010100001000010100011001100110000000101001010001
00100010011000100000010001010010010010100010000000100110000011100001000100000010001000000001110000010
01100001001001000001001010000001000001001100000010100000010000100100010000000000000000000000100000000
01000000010000001000111100101100110001000100000010001001000110010110000010000011000000100010001100000
00000100000000001000000010001000101100001010011000010110011010010001010000000001001010000000010000000
01001100100000101000010101100010110100011101010100110110100000001000100001011110100110010000010000000
00010000000101000100100000100010001001000001100000100100000000000110000000111000000001101001110101000
01011110100110100011000000110000000001100000100100010100000110011001001010011000010110010001010100111
01000100000100100001001010110010000100100000000000000000111100101000001010001001011110000000001000100
10101010101001100100110001110101001100011000000100001100110000001000100101011000100100110110000011011
01110001000000100000001100011100000010000100010100100001010010001010000000001101000000000101001100100
00110000000000011000100100010001001001011001001000000010001110110010101001100100000000010011000000010
01000000001011000001011000000000000000000100001000000011100000000001011010001000001001011010000000000
00000000011001011100000100011011010010110100100110000001010010011011000010101010100100000010001101101
01111001100000000100000000001000110001101001100010100000010101011001010001100000001100000010001000100
11000000000000010101110000010010010001111001011011010110001101100010000110000110110111110001001011110
01100011011001001101000010110101011000000010011111001100100010011000000000000010000001000000000100000
11100001101000000110100010001000010001110101001110101110001001001001000101001010100000010100101100010
00010100001000000010010010010111101010001001110011011000000001100000010000000000000000001000000000000
00010000100110010010000111000100000100110100010010100010000100000000010111001000001000010000110001100
00011010000100110001001001010000000000000010011100000000010000101011001000010000000100000001101000010
00110010000000010100010001010101011000001001001000000000000000111000100000100001000000000100000001100
10101100110010010001000010001010000000110001000000100000000000001001111111001110010001001100010001000
01000000100000100011000000011100010101110010010110000100000000000000001001001010000000001010000010011
01100100010000000110011000000010010010100101000001010100000001101000110001001000000000101000110111000
11001000011010010010010010000100011000001100000110100101001010000001000111010100000001000100000000000
01000011010101100010111000000100000100110000010000000010110000000100100011001001000010001001000011101
01000000000000100010000001010110110011000000000001111100101000000001000010001000000100010100010000001
00011000000000000010111010000000000001001000101111000000000001000011110110100000001000110010000100001
00100000000101001000011111001000000000111101000110000001000000100010010010000100000100000000001001000
00001000010100110110000001011001110000001011000000011010001100010000001100001010000100001110101100010
11000001010001000100101100011000000011000100000001101111010001000000100000101001111000011100000101110
01101010011000010001001010110100110100110000000110111001000000101000010000010100011000010000110001010
01011001010000000001000001000110010000001101000101110000000100000100101011001010100000101001001101001
100010100001010000000000010001100000001001000000000101100010010101001011100110001010101010100000G1010
10000110000001001000000000010001000000100010011101010100000001010110011100010101100000000101001010100
00100001000001100100001010000101011000100000111011000000101000000000001010100010110101000010011010010
01000000000000000110010100000010100010001000000000001100001100010011100000011100110010001010110000000
11000000011000000000100100111010000010001010100111000001000100011001010100110001010000111011101000111
10100000000011001000010101010000001011100100001000100010001010101000000110110010111011010010000010110
10000100100000111100011110100000011001010000010000001000001100011100000000000000000000110010000001000
00101010000100001010001011101000000001110011000000101000000010100000000001111000000000000010001010010
01011001001000010000100010000010100010010110101001001110100100001000000101011110101001001101101010101
10010000010010000011001110000000010000010000010100000000100000000000000100000010000000111101100000010
00000010010001010010010101001000010010100001001000000001000100100001000000011000001100000000101000000
00010010010000000000101100010010000001010101100000000000101010000100000000101000000001101101100111000
10000110000010000000010000100100010101110010000011100010000110000010001000000001100000010000110000000
00010000011010000000000000011111101001000010010100100110100000010011000100000010000001001110010000010
00000010111000001001000000000001010000100100110010010000110000000010110010000011100100011000000101001
11100001011100000000000000000001001010100000011010000100101110000100101100010110111100001001000000100
10011100000001000100001000000101010000100001010011111000000000001011001101011001011011111000110010000
01000000000000000001010100010100011010000000000000100011011100000000011000000000110101010000000010000
11000100000011000000001010001000100110000000000100000100110100001100000101100000110100000000001010110
00010100000000001001000001100000001001100000000010010000000001101110000001011011010110110001010000000
00100111101000011010000100101001010010001010001000000010100010000000001000000011110001000100011010001
00000000011000001001010000000001001100000000000001000000010000001100110100001100101010010011010011010
01000010000000011000000011110001001001000000100110100000100000000000011000100000000000100000010001101
00000010000110000000011001000001100100001010001010000000000001000010101000010000011110100101011100000
00001000100000011110000110100000100001100010010001000000100000100110100010010111110000000100001101001
00010001011000010001001101100001111000010100000010001000100010100100101101010100010100010000000011000
0100110110010000110001000010100100011111000S010000010010000100101000011010101100100100100001000110100
00001010100010100001000101000000100000000001000000000100101101101000000000001110001001101101101011010
00001010110000010000010100011001001100110000101000100001000100100000000000000101000001000110101001010
00100010001100011100000000101100000000001001010000000001001000000110000000000010011010001010000110010
11000000000000000100000001001100111010001100000011000110000010000000100000111000010000110001000000110
01010000000000100100010000100001000000111000000100001010000010100100100011001011000001000001001001010
01000101011110000010011000011111111111101000001110101000010010000100010111000001100011001001000100000
00011100010000000100100111000100100001011101000011001010100111000101101000100000000010001100100001001
00010001000100000010100000111110000000001111000010001001010010000111110001101001001001100100010100100
10001001010001001001100100000100111010000011010000000111011000010011000001100001100000000010010111000
00000101000100000010100000001100011000000100100110001010000000001000010100011001000010001000100001001
00100100000011001000010101110000010010000100100001000000100010000000101011101001100100000000011010100
00000000100100000000000000000100000110001110111101100101100001001101010001010001100000001000001100000
11000000110101110000000000101010010000011000000000101100010001111101000111000000000001000100001000000
00000000011001100001001011000001000000111010000000000000000010101010000111000010010110100100001110000
01000000100000000000000010100000001000000100110101011000000011100001110001010110100000101100000101010
01001000001000010000000110000101000000000000000010010001001001100010000100110010000001011001000110100
00110000010100110010100000000100101010100010110010001000000101011000011101000010010100100000000000011
00011101110000010000000000001010001101010000101001011110101000010001010000000100000100001000000000000
00000001010110100010100000001010111000101000000000001001000000010100001100000011011001100011111000001
11110010110000001000110000000010000011000101011011000110010000000010000000000011100100101010011100101
10010000011000000000010000001001011000001000001000110011010100000010000100011000100000010100000100001
10001000000101011000110000001010001101000011010110110011000001001100000000011110001010001110100010000
10000000000000000001100010010000000110000101000001000010001001100000111100000100000100010001000000010
01100010001101000100000100010010010010100000000000001000000001001101000000000011100000000000000100000
10001000100001000101000001001011000001011001101000011010010001010101001000001100010010000001001100000
01000000110000000000011100000000001100000100100110101000101000000110000001100000000011000110101000001
00001001000000010011010011000000011101110000000010000000111001000000000000010001001110100000000000011
11010000010000000000101000101000000101000000000000000010001001011010100100000000010010101000001101000
01000100001000000000001111000100111100000100011100001101000101101000010000000000001101001111010000100
00001010000001010011110000011101001101000000100101001010001010010111000001000000101100011000100000001
00011100001101000000000000011010011100000011000010001000101101010011011010001110000101011010001011001
00000000001100010000010101010001010001100001001001110101010000001100100000100100000000000100100001000
00001000000100001000100100000000001001000000100000110000000000101000000010001000001100000000011101110
01000100000001001011110000000100110000100000000100001100000010000101000000000010000000001000000001100
00000010000000101000000000001000000000000000000000010010000000101110100101101011101010000110000000010
01110001001100011000001001001000000001000100010101100000000000101010001000100010001000000100011000010
01001011001010001100100100000000100010101000000000111000101010000001100100010101010100000000010011101
11111001100000001001100000100001001000010000000000000100010010000001000000001000100000000000100111000
11001001100010100110101010100101000100000010001010111000001001100000001011110001011000100000001100011
11100010000110010010000011001001101101000110000000100101000000000000001100101011000101000011011010110
