00000001001110001010001000110101011001000100011000001010000001000001001101101100110010100001101101000
01100001100100001100000100101010001000011000100000000000001001110001000111100100000010000000100100111
00001011110000011100000000000001111000111000010000000111100011101000000011010001101001000100001001010
00001100000111010110000101011101111010101011100000010101010100000011001010000101000100000100000000000
01010000100000010010011100000100010000001000100000000011000000000000110011000000011100001000000100000
0100110011100010000010011011000101010011000101000101000010010S100000000010000110000001001000001100110
10000001000000011101001000000110000110101000101000000001111001100001010010000000000000000101000111000
00000010001000100100000101100000000010000010100000100101010100101001010001000000000000000110011101001
11001011001000100100000100010000011100000001110111110100000000101001010000010010000100000000010100010
00100000111000110011011010000110101001100110110000110000110100100000000010100100100000100100110010001
10000100010000000010100000101011000110001100100000100001100101001101101010000000011100110000010010100
00010100011001001110000010001000000100010010000001000010110000010000110101001101000011000001000001000
00010000100110010000010100101010000000011110000111000110100000001001001000001010000100000000100010000
00000010101011000000001111001010100000100000000000100011000000010001000100010100110000001000010000011
00010010000000101000011000010000000010000000000000001000110011000000001001110011101010000011000010100
00001110010000000010010001111000010100000000101000010101010101101000011000000001100001111000111000010
01101000001001010000100000100011000111001110100010100001000100011000100100110000000000000001111000001
01100000000010000001000011000000000100000010101101001010010010000010001100000000000111000000101001000
01000010011001001101001010101101000110000000111001000001001101100011110000010001101010100100000010000
00111000000000000010000000000010001000100000100101000000101100100101000000000110010011010000100010000
00101110000110010000110100000100101101010000110110000100101111000000111000000001001100100000100100000
10010000110101010011010001100000100010100010000100000000101010101010000001000000010001001101100100101
01001110011011001000100111100100G10010011001110000011100000001100001010110100010001000000000000010010
10010110000001110000010100001000001000000000111010000100000001001010111001000100001000000000010000000
00010000001011000110110000000010000001000000010100101100100011001000100100100001000000110100000001000
01011011000100000000000001100000011111001010010000011000100000100100001101010001001000110110010010100
00000100000000100101101001001000001101010000101100000100111110010011001100000001000010000010000101000
00100110000111000010000001001100010100010000000000101001000101000000000000111011000110000011000011000
10000000010001011000011000110011001010000010010000000000000001000000000000001100000000010110000100110
10101000000100010001010000110000100000000010011010011000000000001011000111001110111000100010001001010
01000100010101110010001110000000000011100101000010111000010000001000010000000100000100000001000100100
00011000000011001000111000001000110100010001100001001100000000101001100101000000011010001111000011100
00001101110001010101000000011100110100011100010000010000100100100001010000000101100000011100110010111
00100110000000001000000101000000010000100010101001110110001000011110000101000100000000000100101010001
11000000001000010110110111001000000100011000000000100011000001011000100100110000010000001100000000000
10000100100100110000000000111000000010000100100110000100000000100000101011101000011100000001000110000
00100010010110000010000000100101000000100101000001010100011011001010000001000010111010000111000010100
00000001000000000010100000000001001000000110000000101010000100100101000000001001000000010000000000111
01011100101100011101100010000110110000010100101010000001001000111000010110010000000110010011100000000
00101000000001000000000110000011000001010111011100010011000000100000000100001000001010000100001000001
10000100001101101100001000010100100110011110110000101111001000000010010000100010000000010000110101000
10000001011001000010110000100100000110011001000000000011011100000100100000000000000010100000100000100
01010100001010000000010000100000111000100100001000000100101000000110100001000011001000011000011010000
00000001000010000100100001010000000000010001100011000010110100001011100010010001000010001010001010000
10000001001000001011000100000100011100000110010011101000001000000001000011110000001101000001110011000
01110000100000000010100010000001010000001001000100001010101110010001100011000100110110001000001101000
01010000000110000001000010000000100000000010000010100001000000110000001000001000011000000100001011000
00101000001011001010010100000010010110100001000100001101100001000100000001100000011000100000000010001
01001010001000000100000100010011000100010000001000001011100100010010001000110010001110000010000010001
00000010010010000000010000010000000000000000000001000000011001101000110110010011000110100011011100011
11000000001000011010010000000101110011000100011000001000011000100001000001101000000100100010110010000
01000010001000000010101010000000000010010100001100001010011010110010001100000001010000000000101100011
01000100100110100100110001000100000100110001001000000000100000100000000000000000010000001110101001100
01010011011000000000000000100010101001011010101000010000001000000010101001101010001000100000001000001
01100010010111101000110000010100000000000101100001011001000010001000100000100100010000000110001100000
10000110000010010000000000001000010010000001010100000010000101000100101000011000001000000000000000110
10101000001100001100001111000110100011001100000101101100010000000011000011011001010010010011000010011
00000000100101110000110100001010100100000100000000000000100000010010000000000001000010000011001000110
00001111000010001000100011010000000000000000111000000000001000100100101101000101000000001001000000100
10001100011000010011010000000010000010100010000110000100000100000010000000110010001001101001000000010
10010001100000111100100010011000111111110000010000101000000000110000000000000100100100001000000100010
10011001011101000001001100010001111100000111000001001100000000010011000100110000001101100110000000010
01000011000000010001000001001001010010100001100000100101110001010100000001000110011000000100110011000
01000000000000100001110110100010000000100001110100010000010000101001100100010010101100000011000100000
01001000010011101111001110000000100000010000001010101010000010011000101000110010110101001000000111000
01111000000110011000010000100110001010000000101000000011000000000110000011001000001000000100011000100
10111000000100001011000010101010000110000000111100010001100000001100101100111100000001001110000101010
01000000111010111000110000010000000000000010000000010010011000010000010001100000001010111000100000000
00001100010100000011001001100101000100100000110010110111010100001000101010010101000100000100000101111
00000000101110111010101100011111101000000000100000010010100000000000100000000000000100001010100110010
00000010100100010000010010000100010000001010110001010001000000100001000100000011001000100000001100011
01010000001010011110010001100000010000000010000000000010100110100001000101100010100000100000100001111
00100111000000101010000000010001000000100000001011011000111010110001010001000000000001000101101000000
00001100111001001010101001000110110001011010010000110101100000000000010110000010000100100000100010011
00010010011010001010101010001000000100000000011000001001101000111100000111001100000110001100101010000
01001010001010000000000000100111001000001000000100001001000110000101110101100100000110001001100000000
10100001110100010000000101000001010000111000000011100111000000011000001100100001001011100010000000000
10010101000000010010000000001110000010110111000010000000101000000101000001000100110010010011000001100
00110000011001010100000100000010010110000011000110000100101100001000010100000000001010000000000010010
01000000000000000000011000011000101001011000000000001000100010000000000010011000101000010010000001100
01001001010100010010000001000001000100000000000100001000100010010100110001101000000100000100110100110
00110000000000010110100010100000000000110100011100001010010010100100100011101010001010110000000000111
10010100100110001000100110011000110110100100010101000000010100111010000101000101100100100100110001101
01100001011001000100010110110000011000000000100001001101001010001101110111000000000000000110010100010
00000010000000001001001001000000000111001010010000001000001010000000000101111000000110100000111000011
10001010000110100000000011001010000000000101001000000110000010011001001101011000000010000010000000000
01010010000000100001000100010100010101010000000111001001100000001000000100000001000111000000011000101
10100100100010100100000001000101000000001011000010100000000000000100011100000000101101000010110000001
00001000100000000000001010100100000000011100101000000001010010000000010111000000001000000001000000001
10000011000100100000000101000001100000000000010000011000100001010000000000000000101000000100000101100
01100001101000010101000011001011000100010001011100000010000010000001000001001110000011100000000010000
00000100000001100000010111000100000001010000010011000000000010000000100001001010000001011000001000110
01000000100010110100101001001000000000101000000100001000000001000001010110110010001001100001100101000
00010000000000000000001111011000000000001000011101000100000000101000110000110100110101100001000001000
01000000010000000001101010000010000000010010000000000010001010011101010010001101000010000001110011100
10110010000011001000100111000000000001010100000101010011010010001000010000001011001010011000010010010
01100111100001100000001001001011001000110110011010001001011000000001001100000001101010000000010100000
01101000000110000010100000110011100000000000001010001110000001100100100001010000101000110001000110000
01000001000000001000001010000000000100111010100000010110100111100101000100000010011001000000011101100
00010000000100010100100101000111000010110010000011000000100100100000010000000000010100001100000100010
10100100001110111100000101000101001001100100011001100110000110000110000010000000000000110101000011000
