00110110100001000001100001101001000000011100001100001000000010011010000010001100100000000100101010111
00000000001011010001001000000101001011000011111100011101010000000000001001101111010010100000101111000
10101001001100000001001010001001100011100001001110010110010000000100100000000100111000000100000110000
10000001000010010000000001001000010110100001100000000000000000000000010100010001011001011000100101100
00111000010010010011000011001010000000100010111101000100001001110000001000000011101000100011000000001
10001010011001000000100000100000001110010000001000010000010001000000010100010001001001000000000100010
10000000000001001001001000111000001100010010101010000011100001000001000010101000010001000000100110000
00100000100000100001000101000010001001101000001000000100000010000011001101000011001000000000101000101
00010110010010010101000000000101101010000001001001100001100010000011000010110100000000110010100000100
00000000000000000000000000100100000110000001010100100100001110001100100001100000000001010001010010000
00000100101010100000011010000010001010000101000010010010011001000110110100000101001000010001000010000
10100100110001001000011011010111001010000100100000000000100000011000010000100100011000000000101001011
10000001010100101010110100010110000011010011100000010000100100000000010000101100000011000001001010000
00110010000000010000010000100000000100000000001101101100101000001011000001010000000101001001010000000
00010000010000000100100000100010000000011100011010000110000001000010000000001010010000000001000000000
11000101010011010010000110000100110000000010011000110010001001010000100000100110000000000010000000000
11100001010011100000001000000000101100001110000011000101000100001010010101000000001101000000000000101
00000010010011001000100000111001011000010111010011010001000111010101010110001001001000010100000001010
10110010000000001001110011000010100001100100000010000100001001010001100101010001001000000011000110010
00000100010000011000000011001110000001010001000000101000100010000001000110100101101100101101101011000
00110110100100000001111110100000100000000011000100001101001000000100000000000100000000010011000010000
10110010101100010011001100001001100000010111100100100000001101110000000010010101000001010110111001000
00010101100010000100010101000100110000000000001000101000010000000000001000100000011010110000001010000
00000100100110010001011010000000000110010110101000001000001000000100100001100001011100000000101100111
11110000100000010010010010000010000010110001000000001010110011011011110100000010011100010110100000110
00000111001001000000111000100000001111011110000100100000001000000000100000100000100000000010000011000
01101000000000101010011001000011000000000100100000111001000100000000110111000111100000100100000000000
00100101000000001101000101100000010110000000100000000011100100001101010100111000100010001000011000000
00001110100100100111100010010001000100000000000010000001000101001111110100000000000001000000010000010
11100111001010100000010011001000000100101000010010001010101100110100010001001000100000010011000000000
00000000110000000000001000100100110000000001110000011100000001000010001000000001010011100010000001000
00000001000110110000100001010000000001000101000110010110000000100000000010110000100001001000001111101
10110000100000010001000000101000000100000000000100000001100000010010100100000010000010111011010000100
10011011000000000000001000001011101010000010100100010001000100001000000000101100111000000110011001110
00000011000001010111010100000010010110010101100110010000000100001100000000000010100000100000000010000
00000101000000010100011000100010000010001000001010000000100010010000000000100000010000110001001110000
00110000001000011010000000001111110010001000000100010110100100101011101000101000111000000000001001101
01011000001100110000010011100001000100101000101100000010000101010000000000010100100010001011010001000
10110001000000100110100100000010000000000111000000000110101110000000100101010101000010100000010111010
00000000000000000001000001000001000000001100100001001000100000000000010111101010011001000100000000100
00000000000010001001100010000100000100000010000011111000100001010000001010000111111000000010010101101
11100001010010000100100100100010001000001001000010100000110110100110100010101000011011000000101110111
00101000000000110000001001110001000000000001000000010010000100001000001110001100010100000001001001001
10100100001100010000001101000000000100100011001101001101100000010000100101000000000001001110000011000
10000000110000110000101000001000000010110110000101000110100000111G00010000010000000000001000000100000
00000111101010110010000010000101010000000011000000001000001001010001100001011011101100010000101100001
01010110010000000101000001001101010000010011111011101000000100101001111100100000001001100000100001001
00101011101000000110100100000000101000000011001010001001000100000010111000011000010101100101000110010
01000111000011100010100000100000000000000001100100001001010001001110001011011000001111000100110000001
00000111101100010111000111110100100010000000100111001100100110111000110110110100001101000011010011101
01100010110000000111000111011000001101010100000000010010000000010000000001000101100001101000000000000
00100111000001000100000100000101001010000011000110000100000000011001010000101000011001000001100000001
00001000010100101100000010010101101000101001010000000101001010100000010101110010000100000011000010000
01001000010111000000010000010010100000000000010001001001001011101000010101100010100001000000011000101
00010100000010100100011011001000000000010000001000001100100000010000111110010001000000110000001001000
00000010100001111001100000000000000001000001100100000011000100000110100000000010011010010000000000000
00001100100000011101000000001011110000100000000110000010010000100010001000001011110100000000000010000
00101001010000011000010010010000000000000011100110100000100010110001100000000000110010001100010001000
01000001000010000000000000101000100000010001010000000110000001001100000000010010110010100101010001110
01100010000001000000000000011010001000000100001100101010000000001110000011100000000000000000010110001
01001000000010100100010000000001000000000000000000000000000010000000111010000100000000000010100000001
11001000000001101100100010000110000000011010111000000000000110111010110001001001001011000000010101011
01001010000000000000000010000000001001100110000001010100001011000011000110011001011011010000000101000
01100000000101011101101000101010001001001000000000100100000101100101100000100000000001100001110100011
10000010010000011000100111000101100000110100001110001100001010001000001000000000000000010011110000110
00000011000001000011000001000010000010000100110100000001001100001100000011000100010011110010101011000
01000000000001001001110010100000011010001010010001010000001110000000001000000000010000100000000000101
11010101100101000000010001000010011010000000001011000100010100000000000100011010101000000010110101000
10001000110010000000010110010000100011000000010000000110110101000101000100011000101001100100101001011
10100010010010011000000100010000000001000101001010100000000001000100000000001000001000000010010010001
01000100001110000001100000100001100110000110000000100001010001000001110000010000001000000010010100001
10111101100111100100000000000011000010010101100001001000001011110010001001101001000110000100101010011
10000000001000010100100010011101001000000110100101000011000010010100000001110100000000000001101100010
10000000011110001000011110010100001000010000000000100001010010000010100000100000010111010100010100000
00110000001011111000010101100110001000011011000010100111100000001100000111100000011000000000101100010
01000000010001000001000000000001000100010001010001100101100100110010001000000001000011000010100110010
01000000000000100010110010001000011001011001100110110011000010000010001001010000100000100011011000010
10010001000000100010000010001000000000010010000010000010100100001010010001010010001011010100100000000
000010000010S1010000100010110001010010010110110000100001000000011000110000000100101101110011011000101
00111000100000100000001010001100000100011010001001000100010110101001001110110000000011001000000101010
10000111001001000000000000000000010000000010000100001010000000101101001011010010010000011010001000001
01000010100000000001100000000010010001010010000000000000100100011101001000100110101110100010000000000
00101001000000000000001110000010001000000000000110000100011010000100110000010100001110000100001001010
01000011010000100001000100001100000000000101100000100100000011000000101100000000111001000001001000001
00110101100100100110110000100010101111110000100000000000110000100010000101011101000011000001000000010
11110000000001011001010110001010001100100001000000100110001010000111001100100000001010110100000000010
10000000010000000000000110010100001010000111100000010000100001010101110001000001010001100001011000000
10100100000000000010110101110000001000011110010000010000000101010110000100001000000010000100001010001
00010000000011110010110000100010000100000110011000110001110000101101001100101000100000001100100000001
01000111000010010001000000001001100000000101010000000101000101100000010100100100011001100000100110100
01011110100000101001001010000000001000010000010000001000000110000110000001000000001000001011010001001
10000011010000010100000010101000011000011000001010000000000001000010100101101011011010101000000010110
11101111100001000010000000000010100110000011100010011000000000010000000000000010011000100010100100000
00010001010000001000000000101101000001000001100000001011000010100100000010000000001001000010010000011
11000000100111000100010000010000101011001000011000010001000101000000000000010000101000010100000010000
01100000000000000010110001000001111011001011000110100100100100000000000100000011000101000000000011110
01000000000001100000000100111010100101011100111000100000101001000010100010010001010001000000011100110
01000001001011010000001100110100010010000011001100110001001010100100110100000110000000000100101111001
00000111010000001011000010011010100010010001000000010100000010100101010100001010001010001010100000000
10110010110100001010010100001010101100010000000010000110000100110100000000011100001001001110010000000
01000100000000001001011010000001011111000001111001000100111000001000101010000011011000001100000001110
