10001101010000100100011000000000010110100100000000010000100000001000000001000000000011001000000000110
10000000101001010100010011000000011000000000001010010100000111010110000000010000000001100000011100000
00000000010000011001000000011010010010110111100110001100010110010010101000000001101010000000001110111
00010000100010000010000101000001001100001100001000100101000001000010001010001000101000000011010111100
10000001010101101000001111100011000010000000100000010000010010000010110100110000110100010001111000000
00000000000110000100001110010000110110110010010000001100000101000101001100000100101000000010010111000
01100001010010110010000010000001001100001010011001000000111100000000100010000000010011100000010000100
10011000011000000011010010000000000001000000001101001010001000000000000000000101100000110010100100000
01100011001011000100111000010110001100001010000100000000000010011100011001010000000000000000011000010
00000010011101000100101010000000001001000010001001000101101110000000000000000000000000010100010010011
00100000000011000000111001100010101100000001000100000000000000010000000000000100101010000010101001100
00000010011101100011010110110000011100101001000000001100100001010001011000010101110010000100101000010
00010101011001010010110110000100011000010000100100010010010110010000100000010011011010101000101110100
01001010101100000001110010000010100001001000010011000000100001011100100000010011101111001001011000000
00101001100100110000010000010111000100000110000101010100000000000010000001000011100000010000100101011
00010000000000010000000000001000000100100011000010100101010000100000001000011001000001110100000101110
00101100101000100000000010010001110100010000000110001000010001011000101010000100001101001100100000010
11000000100000000000101000100001000000000000100101000000110010100001100000000110000001010000011101011
10000110001000110001000000010111010110111010001001000100000100010101010001001100000110010001110001000
10000010000000100001000000000010000010000110010101000100111001110010011001001011101000000000000101010
00000011010011110111101001001000001001111000011000000001111101101000100001010011110101010000000100000
00001110011100101010100000100101101000100000011000000110000001100000011011000000001000000010010001001
11001100000001010000001100100000011110010011100001000100010111001000001000100110001001100111000011110
00101000011001001011011010000110110010100001010100001100000000100110000101101000001000000100001000000
00001100001000100100100100001000110010100000010111011001000010000100000000110110000001000101011011000
10000010000110000011100000010111000010100110111000100100001101000001010001000001000001001100100100000
10001000000000001100010010000001110000000100100010111000010000000100000101010000100001100100000011000
11010110010000010000000100000000010001110000000000100000111001001000010000000000001000001010001100011
00011000000100010100000000100100010010010010100001000000100100000100110000001000010100101010110000000
11101000000111110001010110101000100001001001110000000101000000001000011101000001101010000100000000001
110011010001111000010100100000000000000000001S0100000001101111000000100000011110000000010010000101100
01000000000000111000100000100101100110000000000000010010100000001000000000001000001001100011000011000
00000100000100000100000000101000000000000101000000010100000010110000000000000000010111100000101000111
10110001100101010100000011100000001001000000100000100111010011000000100111000100000010001000000100011
00110110010010000100100010001000000001000001100000011101111001101100001010110000010101000001110101000
10101110000010101010000011100001000000000010010100010000001010000001000110001110010000001001101110010
00000010000001101110100101001010000111010000000100010100000000000101100000001001011001101010011000000
00011010111010010110010100000111001000010101100001001011000000010000010000101001000111001000000100101
10100101000000010101000001110111101001100001001001100110010000000001100000001000100000000000100010010
00100000101000010000000011010010100101000101000000000010001000001011010110001001000000100111100010001
00010000100100000000101011001000000000100000001000000101000000000101000110000001000000010010010011100
01000110000111010100001010000011000100001010000011000000000010000111001000000101001001000010100010101
00100110000010001011011011000001101010100100001001000010001110000001001001101001000100010100010100100
00100100010100000000001010000000010011010000100100000001010011010011100100000011100100100001000000010
00110100000010001000100000100100000000001010100000010010000000100000010101010010100100000100010101110
10111110010000110010000000001000010010111101011100100100001011100101100000001100000101000000000010110
01001101000000000000010100000101000000001011000100010000100000000001010000010110100000000000000001000
00010100000010010100110000010010000000000101010001100101001101001000100001101000001011100000010100100
01100010000000000000000010100000101000100000011011110101011001011000001000110100011010100101000010001
00001000000010100101000000100001100010000001100101000000010011100001000100000010100101000000000000000
00001000000011001011000000100001000001011011100000000111001001001001011000101110000000000010000001001
00001010000001111000000000010000000001110001000000000000000100001000101000000100000000000110101100100
000000010000001000010101110G0011110010000000011101001000100101110010010001000100010000011011100000110
11010110001111010100010000101101010100100001010000001001000000000001001111011010010100000001001100000
00111100000011000100011100010000000001000011010000000000110100100000010000010001001001110010001011100
00000000010010010100100011101000001000100001100000011100000001100011001000000100110010000000000011101
10000011100000100101000100000001111110100000000010000101000000000111000110100010001100001000101101011
00000000010100000000100010001000000000000000000100101001000001010000100010000111000101000000010001000
00000010010011000000011101000110000010110000000010100011010100000010000010010001100001101000000101000
11010001000000011001110010010000010011000000000000000101101111001000110100000101011000001000010001011
01000111000100110000000110000000100000000110010110100101101101000000100010011101100101000000001000000
11111001100100001000001000000000101000000100010001000100000000010101111100001000000010001100001010000
10101000100100001000100000000000011100010010011001100001000000000001000000011010011000010000010001110
10001100101000010100000011001000011000000000111100100001000100010001000000000101000100000110001011000
01110011000010111000111000101000110011101000110001010010110100101001100000010000000000101000010100001
01000001010000000100000010010100101000000000010000000000010111101100001000001000000000111100010011100
00000010000001000101000100010000000000000010010000111001000001010001000101000000100011011000100010101
01000110000001010000101010000000101000001100001010000000100000011001000000101101010100010000000101111
01101000000000000001100000110100000001010101100000000001100100000010000000000011010001010000001110000
00011001000100000010000000001100001010101101000100000000000010000101001010100101000101000010000100000
00000000000000101000000111001000001000001110000101000100000000110100010011000000000010001001010011000
10000101110000010110000011000000000100010100110000110000000100110001100101000000001010001101100000100
01001010000001000000000100010011000001010001000000000010001000001000111100010101010000001111110001111
00000011111100100110000000001010011000010110000011000001001010000110000010000001001000100110100011101
00000110010001010100010001100001101100000000011000101010000010000101000001000000001000100101000000000
10011100001100001000001001000001111101001111010110010000101000100101000100000010010101111110100100001
00010011000100010110010000000010000100010000000100000000001001000010011100010010000011101001010010000
00010000001000000000100011010001000000000000000100110100011001101100101000110010011100001001000001100
00100011011101000000001010000110010000110010001010101010101000000010101011001000001000000010110000000
00010110101010010111010000100010001100010000110001100011100001010010011001010100001000001101010010001
01001010100011001010000000001010000010001000001000000010111000011000010000100001101000100001111000000
00000000001101001000001100000001001010010001011000011111001010110001100100000000000000000010110001010
01001000101001110100110100010100110101110010000001001001011100010110000000100000101001010100101000100
00000000000010110100000100010000000000100000011001010001001000010101000111011000100000100100010010000
01000000110000000110000000110001101000100010101000001000101000101001000000100000000110100001110100010
01011001000000100011000001010000001000000000000000111100010010000110000001111010000101101000101000110
01000000100000010001100101100000010000100110111100000001101010110101010100101101001001110000001010001
00000010000000110000011001001000101010000000100001100010001000101100100001001011011100101001100000000
11001000000101100001000110000000101100000111100011101100000111010001000000011100000000110000000000100
00001100000111001101100100101000011000000101010100100001010100010010000011000100001000000000010010110
11110000011100101000000000000000000000010001001000001011000100001011000101000111000000111000000000001
01100101101010100100010000000110100100001100001011001010000100000111001001000000000000100000000010001
00000011110000110000000011000001000100000010000000010010000101001010001110100001100000101000100001100
10010010001001001000000001000100001100100011000011001000010111000010100000011000000000110000011111110
00110000101010000100100000010000000010110110000110000000100000011001001001001001101001100000000101010
00000011111000111010001000000000010001010100110010110011100001100101000100000000010000000001001000000
00101100100000000011100001001000011100001100001000100000101000110110000000001100001001100010100110011
01100000001000100100001000000110000111000110111000100000000001000100000101000000000010000010000010100
01000100001000001001000000000010000100000110001011101000101010110000010110011110000010100001101001101
10010000001010100110101000000010000000101000000101010000100100000100011000011100110000000001110001011
00110101000100010001000111000100001000011100100000010001010000110100110100011000001000001010010010011
