00110101000000000100000001001110010100000000001010101011101000111000000001101100011100011101001000100
10011011001000101000100100000000001010110000110011010101000010000011010010001001011011110011000001000
00101011000110010101000111000100110001010111110000000000000000001010000110001010000010100000010010001
10101001000011011100110111000000000000001100001110101000100010010000011000101101001001000100000011100
11000010000011001100100000000000110001101000000011101000000000001000000001000101000101100001001100100
00110000110000000001100110000100000000000101111011011001000000000000000111001110110010010010010111011
10011011100100110001000100010000110000011010000000101000010101011000001100010001000000010011001101000
10001000000010011001101101000011110001001000000000101000111111001000001010101111000100001001000011100
01000000000110000000011100100101100100001000010110010011010100110010000010010000011000110000000100000
11010101000010010010110001000100001011100001000100100011000000110001001011000011001101100111100100001
01001010001110000000011100110000101110011000100000011010010000000000000111100111000011000000100010000
01001100010110010000000110010101011111111100001100011100101110000001010100000001011110000010101011000
00000101000001001000010000111100001010001011110010100101110101100000101000000010100100100001000010000
00100100000100000100001000101000000000000101100000001100000000001000100100000000110001011000010100000
00010010000100101100100000000110000111001000001100000000000001110110100100001100000011010000100000000
00000000000111001011000000001000000000000000001000001000000100010101000011100000100100010010000010001
01101100001000001000000100101100000001000000001000000001110000110000000000100100001001100000100010000
00000100011000110110100011000000011000000001001000110010000000010000101101001000000000100100100101000
00110100001100000010001100000010101001000001111010000100100010100110000110000000000100001000000001001
00000001000000010000010000000000100000100000101010010010001100100000110110100011110110000010100001010
00101101101000000011001001000001110110011110110000100001001000000001000101100110001000010000001000111
00011100001000000000110110000010101010000010000000010100010100110001100000000000000010100111000001001
00011000000110001000010001000010110001100010100011000000000000101100101001101010110100000101001001100
00000011110000100111010000000001010100101110110000000100100000000000001000000001101000110010100011000
01001001010000001010001110001000110010101001001101001000100101010001100010100001100001000011100001001
00101000010000001110101100111100100100101100001000100011111001110000100100000000110010000000000G00000
01100011010000000000111011101000000100000110010000110010000110000100010101000010100011101000010010010
00000001000010000101000001111000100110100001000100100000010000010001001110010001011011010000010000000
10001111100001000011011110110000001100110110001101001000001010010000110000011001001010110000111011000
10001101010001001000100000000011011101000000010000000000000110101000010100001010000000000100000101010
00001010100000000000101010100001010100000010010000001001110110101101010010011000100100100011001001000
10010000100001000000000110001110000000111001100011100001010001100010010000010000000110010101101010001
00100001110100000011010011100011000100000000100010010010001100001100001100000001001010101000010000101
10000100000001100010000000010000011010001100001100010000100000010100000010000000000100001001000000011
00000000110000100100000001010100000001000000101011001100100000000001000000100000111000000001000001011
10010001000011010000011100000001000110011010010111110010100000001000100001001010000110100001000000000
01100110100010010000000001100110000011001101001001000000001000010000100011010011001000001000000001100
10000000011001010000100000000100010101101000110011011000110111011010010001001011000110000001011010000
00000100000000101001010000010000010001100001010111000000000001010100011000000110000000100000010000001
00000010110001000100010111001001010010111010101010010100010000101001100000001011000100001100000000000
11000001100001100000100000110000000100010101010010001110101000010011011000001001011000100011111100000
10000000010000111000000001000100001000010000000000001000000000100001000000001101010000100100110001000
00001110110100110100000000000001010011000000000010001011010000101010000000010001000000010010000010100
01010000111100010000000110000000000010000101000111000010000110011110000010000000000000000011000011001
10000000001100100110000000000100010011011000011010010001011000000011000001111000000010111000111001000
10001100100010000100010000111100100010100011000010000001000000101101110010100100000100000001000101000
11110000000001000000001010101010101010100111111011100010010001001000110100010000100010000000010000001
00010000010100111010010000110000100010110000110100101001010000001100100100001001000001000011000100100
00110000001100011100000010000000001001000001101000111011011001011101001001011000111001100011001000000
01111110101010100001001010000000010101000001010000100001011000000000000110100111001001000110010000011
00000001001100000011010000010011010110000011000000000010100000000000111001000001110010001011110010000
00101011000010101000100001110000000011010001000101010000100000100101001101100100100000001100001110110
000000010000000100000011111000100S1010010010000001001110010000000010000010000011000101000000000000000
01010001000100100100000000000000110000010100000000111010001111000000001000101001001011001010000001010
10000001001000100101100111011000000100010100000010000110000000001110110000000000101000000000000000001
10010101100001100010011100000000000100100000000101001000000110011010100010100000010000001110000000010
11100000100000011000001100000000001000000001010101000011000110000110111010101101000000100010100100000
10000101001000001001000001000101001010001010100011110000101000001101000000101000000000010111011011101
01001000100000001001010000000100000000001001000010010100100100000110010000001000100110000101100100100
00001001100001001101000010000100000110000000111011101000001000000000000000010101001101011000000100000
00010010100010001101100100011101000100100110000010000000010001000010000000100100010111011001001101010
00111000100101000101000000000110001000000011000001010100000110010000010100101000010010010101001000001
11000001001100100011010001010010011001010001000010110000000010100010010011011001100000000000100010010
01001101000010010111010100011001000100101000001000000011000000110110000000010001010001010101000101000
00001001100000100000010110111000100110000010111010111010000101001000110001000010100000000100000001000
00001000000001000001000001100000000111000110001010010011000001010001101100000010001001001000100000100
10001000010011010100000001100000100010100000000100110000000000101011000101110110001100100010000110101
01000000010000010010101011001001001010111000100000011000001001000010000000010100010010100000100000110
00010101100010001000011000100000000000000100000100000011000010011000011000100101101100000000001000100
10010110011000010001010000011010000000011000000001100000000000100000000111000100000000100001000000000
00000000001001010010011100101010100001101000000000000100000001100100000100100000100100000001001100010
00110000000001000000110000000000100000001001010100001000111000001100000100000100100100101101110000001
00001110000100001110100011000000000000001000000000000010000011100000100001000000001001001000000101111
10110101001100001011001000100111001100000101001010000011001100000011100000101110110010100000100001011
11000000001000000110001001100000000010000100001001000000000000001100100001000010100101100101000000010
00000000000010000000000000000000000000001001000000000101000001101100101000100001000000000000011000100
00001001010101110000000000100010000000100000000000000010101000100011000100001000100010100000010010001
00010001011000010001100100001001000111000000101001001001000010001100010000001010000000000011101001000
10100100000011000000110000100001001000111000000110000001000010100000000000011000001000010000000010011
00000100001000000100000011000000100011000000010000001100001000100000000001000000100100001000011100111
00001000000100010100010111100001001000010000100100000000000011010011010101010100110010000000010011011
00110000101100000000100010011000011100101010101001110000000001001110000100100001010100101001000101110
10001101000001001001001100000000110000000000000001000001000000100000011000010001101000000110100101100
00000000100110000010010111000011000000001000000100010001010000000000100000000100001010011001000011011
00001011000111000001000001010110100001000000001010000010010101010000010101000100001000010000100010111
00100000110100000001010000100000100000011000110100010000101011001001001111010100100110000111000000110
00101100000001011000000110100000001110101001001011100000100000000010100000001000010000010001010000010
00000000110010000000010000010000000110000011000000100100001100101000010110010010100001100100000000101
01000100000010101001010100100000010100001001101000000001000000100100010001000010000010100000000100100
00100001110101101000000100000100011010000001100001101000001110110011111001110000001100000110000000001
00000111001010000001000100101000100001001001010110000100000010011000000101100000010011011110011101110
01101001110110100010100001001000000100101001000100010010010100000011000100001101001010011011000001100
00111101010010100010000100110000000010000000000000101011100000001000101000101010000100001100110010010
11010011100110000100100000010000000001100001000000001001101100001101100000000010100110010001100100000
00000000101011001111011000000010000000101110010000000000011100000011111100110100000110001010001001101
01100101001100010000010000000000000100011110110001000010000000100101000001100000000100000100000010100
11000010011111010000000001000011010000001010000001001001000000010010000000000000001000100010000001011
01000000001010110110100000010000010000000011010110011100001101010010111011010100001000000000011000010
00110100001000100000011010001010011000000000000100111001100010100011000010100000010000001010000010101
00110010000100000000001100111000010010101000010100110100111011010100001000000101011000001010001101110
01110001100010001001000001000000010100000101001100010001000011011110000110110000011001000000000001000
