00100011010000000000000011001101100000110000011001000100001100110100100010110100000011001111001010010
10010100101000011100010100000000000010011000000000010100010001001010010001010101101000001000000010010
10000011000000010001001011100100000111000110000001111000000100100010100011000000000001001011001000100
00100000001100100110000011001000010000000011001000000000100000111101100010001001000000010000100100000
01100101001011000110100101000010101001100100010010000110000000000100111000011000110110000000101000100
01001100100000000110100110000000000010100001011000010000000111001001110111001110101100101011011110000
01001001000100001001000000000010000101001000000010000100010010001100010010010010000000110101000010000
10100101001010000000100010000010000010001010010000100100011000000000000000000001100000100000000000100
00100010100000100000011101001000110100011001010001100100000000100000000111111010100100001010111000000
00000100010010100001010001001110000111010010010010111010001000000000010000101001100001101001000000000
00000000010101100010100010010000110000100000011111010100010001000100101000010000000100110011000100000
00000010000010000110101100100100000001100000000101010011100001101100011100001000000101000011100010000
00000000000001001101010100010100000001010100001101010010100011000000001000010110100101000111000011001
00000000000000010000000110110001101100010000001000011101010000101001011100000000101110101010100000000
10000000000010000100000000000001000010000000100000001001000000100001100010100001001101100110000001000
00001001110001100100100000000000101011000101011011000001100000000001100001000001000000110010100010110
00010001010010000100000001010101000000000001100010001100010101011111100011011011000011000000000001011
11101100100010010000101010110010101000010000010110000001010000001010000010000000011100000110111100000
01101011101011101000001000101000100000011000000000111010000000010001000001101010011000010000000111000
00100010100000001000000010001101100100100010000000110011010000001001010000010111000100110110100011001
01000001000000100111001001100000001000000010000000000000011000000000101000010011110000000100001010010
01000000001100011010000010010100011000001100001001001111001000001010010011000100001000011010000110001
00011101011001001010001000001100000000000000011000000001000000010010000010010100000000000000000000011
00101011000001011000011000100010000001000101011001010101000000011000000100011000001000000010010000010
01011100000100000000010101000000110000000100100100110110000100100000110111100010001101010010001001100
01001100100110010000110000100101010000010000000000000000100010100000111000001101110110000010110010001
11100010000000001010000001000100111010001011000000010100001000101001000001000000100000010110101000001
00100100010010011011000000000010000001000100000000001101000011010000000101000101000011000010100001001
01000000001001110000001000001100000100111000010010000000000001010000001101000110000100110001010101000
10001100101010000000100101001000001000000110010000001100010011011101000000100101010000011001000101010
00000000011100001000000101100000001100001101101010000000000010010110100110000001001000001011011011001
01100010110000000000111100100100100000000010111001001000101010001010010000011001101100000000101100001
10001000110000011001001100000000000111101000010000111000000000111001010001000001000010000000100000000
01000001000100000011011101111010000010000000001010010001001000000111000010001000000100000101000010111
00111000000010000000000011101111110000101001010000000000000100000000111001000000010000101000000100110
11101100011000010101001000000100100001000100000000011100000000000001011001010110010000001000000010000
10011100000011000101000000010000010000000011001001001100100000100100000100000001101001000010001000000
10000111100000100000000011111000000000001001000001100000000000000000010001011000000110001000010011000
01010011100100010001000110001001100001010001000000010110101000010000001010011100010101000000010101010
00010001101011100000111100001010000010000111000100000000110011000000011000000100100100010010000101000
00000001010101001010100101100110001000001000010000000010100011000000010100000000000000111001000000100
00000001000010001000111100110101010001110001000010100111001010000001001000100001111000111000101000100
00000110011100100000010000010010110100010000000100001000000010110110000000101000010001001001100000001
10010000010100010000110000001000101011100100100101111001100100000010000010000011001110100000001000000
00000001101110000000010010101000100100000000000000010000010000010001101000010000100010000101010001000
00001001000000000100010001001010100110010000001110010000100010101001001000000010110000010100000000011
01001101111110010010000110000111001100000011000100101010100010000100100011000000001000001010000010101
10001000010100100100000000010010000010010100011000100000001110000010101111010000000000110101011000000
00010011000100011000000001010100001010000000101101010010001010010000000111110000000110000010000000000
00001100001101100001010000010001010000010001010001000111110001011000010001000011100011000100100000101
00000001010000111000000000000010001100111010001000000101010001000100000101000001001010000110011100000
11000101000100001000000010110100100100010101111000100010010010010010100110100100000000000000101000000
11000000000010001000011000100110010110000000000000111000111010010000000110001100100010011000001000000
01000011001100000000111000000101001000000000101000000000000010100100100000010000000110001001010000010
00000001001000011010000001000000000111100100011101011000001010100010010000100001100000000100000000000
01010010000011000000000010001110000100100001010100000001100010101100010100001101101100000001111001011
10100000000100010000000100000010010000110001001001000101100000000010101011010000100001011010110100000
01100010101001000010001010110000111000010100000010111000100000100110000000000010100010100110010111000
10001110000101000100000000010100000011001100110010001100001001100000010000011001000010000011011000000
00000110001100011000000100001101001100001001100000010111001111100010100100111000010001000110101010001
01000101101000000011000100000010000000000000001111101100000001001111000000101000010110100100001001000
11100000110001100010101001000001000011010100011100001010000000111100000001100100110010001001000111100
01000100010010000000010010100010100011010100000101111100011100100000010000011010011010000111100001000
00001001000000101100100010000000110011001000100000010110000100110100001001010100000000000100010000101
10100000010000001000100000010100010011011000100110110010000010000010100011000010100100000000100000110
11000000010010100000100010010000010001010001010110000000100010000001000100000011110000010000010000000
11010100000011000001001000010001110010000001000001000000000010011S01001011000110100100001000010000000
11100001001110001100000000000010011010011000000000000101101000000101001101001001000001000000000000000
00010000100000100100100001000010000010000100000000000000100101000110001000000010110010001000000101010
01000001100101001001101000111011001000101100100000101000110001100100101101110011000000111100000011000
01000010000011011000100111000000110001110100100100010101011101100000000110010010100000000000000100100
10101011010000110000111001000010011010000000000011101001010001100010000010000000000000010000000111111
00010010000100010011001010010000000111001100000000100000001000101000101000100001001000100110100110011
01000000100110100100000001001000000010010000000001010100001100000110001010001000010000010100001111001
11010000000100010001010000011111110000000000010110000010100000010000010000001001010001100000000000100
00000011010100000010010101001100000100000000001001011000011000100010011000001011000001000010101001101
01101000000100000000000001001100001100010010010000100010011110100000100001010000010101000111100000000
00100000101100001001010100000100100110000011000001010100100110001100101000010100011000001000001110000
01001001000010000000111000000001000010011000001011101010010000001010010010010110000101000011000100101
1000011001011010010111101000101110000001010100000000000G100000000010000010001010001001000111100010001
01010101000000011001011011000110000000001000000001100110001000010000110000010001111001100000001000110
00000100100011010001000000010110001001100101001001010010110000010111010001101010001000000000000000000
00011001000000010000000100000000001100000000001100001000011110000000101001000001011001000111100010001
00111000000001110001001000010100000001100110100001001100110000100100000000010110110111011001110110000
01101000000110000100011000000100011100010000010000001111010010000000100000001010000001001010000101001
10100000110100000101000100100010111000101000100100000000110000000010010100111000010010000000100000000
10110010101001001001000011100001100101000100100000001010100010011100001010010011001000000000011001000
00000010110000111000000100000010010000100001011101100000011110000000001110101110100100000010011011101
00101010100000011100100100010100010010000111000000000100001000100000010001001001010000010010001101101
00101000100010000000100000000001010001010000010101000001100000010000100000000000010010100000100001101
11100110110011100100010000100001000010000101001000000001001010100001000100010000100000000101011010000
01001000000100001101000100110000100100001000011100111000111100000001000000000110000100101011000000010
00001010000011000111011001001110001110000010010100100100100101000001001000001000011000000010100001000
10111001110100000010010010000101000000001001001000000010101100110000001001000100000001000011111000000
00101000001010010000000000010001000000000000000000001010110010001101000100001011010000010001100100001
01000000000101010011101001001110000110010110000010001000001010011000000011010011000000001000001000000
01000000010100000010100000000010010001000010000001001100001101100000011001000100000000010101010001011
11000100001000011100000001100000001100000010000000000000100010100100100010000000000110101110100100110
10011000000010010011010010000000000010101100000101100011000110110001010000110110000110010011000010000
00000010010000001010110000111001100000000011000110100010010110000010000000000011110000000011001000000
10010001000101111000011000000110101001100110010001000000101000000101110000001001100110000000010100000
