10101000110000000000110101000000100000001000001001001011100011101001100010101000100011100000001000010
00100110110011001000010010010100000111010101011100010011100001010111110000000111010100000000010000100
01000010000010011000000010000010110111011101001001001000010101100100001100100000001101000000001010110
00100000110000011001010100110000000000000000000000000100100001000001000001000010000101000000000000010
00001000100000000000010000000101110000000011000110000000010010111100010100010010000010100100010010000
11001010100111010001010001100010100001110001010100110000100110000000010001010000101001000000100000010
00100101010101000100000101001000100001010000000010101000000000100000001111000001010100111100011100010
01101100000000000001000000001100010111000101110001010100001111001101101001101010000110001010000000100
00000000000000000101010000100110001000000001111111000000110010000001000000100000001000010100100010001
00000110001001001100000101100011001100001010100001010110010101100000101001000100000000010111000000101
01100100100100100100000100010000000001001000001000000001000011000010010000000001001000100011100000101
00001000010101000000011100000011011010000000100011001000000011110010100100010001001001101000100000100
10000000000000101100100000000000010001010010000110001100110100101101110001010000101001110011101011110
00101001000000011010000100011000001100001100000000101000000010000001001001011010000111000000100000000
10000100100011000001001001100000000011G01000000010000001001100001000011110000001010000110100000011010
01100000000111001001010000011000001001110000101000011011000011001110000000001100001000000101001010011
00110011000110010001010001101101000100101000001011000011000001011010000001100000000001000001010011000
00001010000101001100000000001000000000000001100100000000001000000010000011100100001101011100000000101
00110100001000100010100001000100000101100100000000000010110110100110000110010001000000100000010001000
00100001100000010000000100000101101000010111100011001001000001000100100010000011000100011000100010000
00001100001001000110010100000110010010000011000100010010010110100001000101001101001011101100000000000
10001100111110000000011000000000111000001010111101100000100100000110110110001000000010000000011001000
11011000000001010100000100100010001100100001101001101000010001110110000001110000001010000100011000001
00100011010000000011010100011101010110110001100000100101100010001000000111000010000010000100000001001
01010100000101100100100000110010010000100000010100000000000001011000110100101010000000010011011000000
01000000000000100101010000000001000000000011100000101000100110100000001000000000101011010001000001010
1110010100S000010010010000001001000000100001010001010010101000000100111110000000110100111000011001111
10001101011000000010010000010110101000010000001010000100101100001101010000100000000010110010010000000
00001100010010100100000101000110010100100000010010100000010100000010011000000000001100000010000000001
10001100110011010011101001000100100010000101101010000100000010110101100000000010000111011110000000000
10000000001000001100000010000000101000100010000101000000000000010001001011100110100100101101100011000
01010011111010000100101000100001000011000000011111000010010100001000010000100010111101010001101110001
00100000000010001011100000001010000001001111100000010000110100101000100110100111001000010111010100010
01010000000000110101000000001000000000100101000001000000101000000001011011010101010001010010011000010
00001000111000000000100000000011000010110100000000110101100000111000000010100011000000000011100001010
10001000001001010100000011101101000000000110010100110000010001100011000111010001100001100101100000001
00101111110011111011000100110010010010001000100000000101001100000100000110010100000111110000000000100
00000000010000001110110001001001100100000000110101000110010101000000010000001010001000000100001100000
00111100101101100100001000010100000000000000111000100110010011000000000010010000011111100100001100000
01011000110010001000100011111000000011001001010000001010000010100000000011101000011010110000101001010
10010100110100001111000100101100101001010001100011000100001010010000110000110010000100000000100000000
00000100110001110000100100010101000001101000000001100101101110010101010000000001010000000000000001001
01100010101011000100000100000000001000001010000011000100101100000000101001010100010001101011000000000
00010001011010010000001000100100000011011110000111000000000000110001001100000011001110100000111100100
10010001000000000101000000010111001000010010000000100111000001011000000000110000000000000100101000010
01101000001101001000001100111001000000001110000010000000010100110010000111101110111000010010100001110
01011001010000000001100110000111000001100001101001000010001100000010010001100000010100100010000100101
10010000100000100001001000100100001010110010011001010000100001000101101010000100000000010000100000000
10001001010001000100111000000000011100101001010000011001010000010101010000001001000101001100100010000
00011000100000001000011000100100001101000010010010001010101101000010001010000100110010001001001000111
01011001100011110101000010010011010101001001000010010110000001001010001011000110010010010101001010010
01110000111100000101001100110000100100001100101000010001110100000101110000100100101000010010001000000
00000011000001000000100000001100100010010100000001111000000111101001001000100111000100011010011101000
10011000000010000001000001000001001000001000001001010010001110110001111000100000110110100111100010011
10000100000000000100000110100100000000000111000000010001000101000001000010011010010000000010110000000
00000000001000010001001001001110000000100000000111000010000011001000001010000110001000001001111001000
00001000100001011001101000101001100001000001001111011100000001000000001000010010001000000110110000110
00000001011000000010100000110000000001010101110010000000100110000000000010110000000000000011001110010
00000000001101100001111000010010000000100100011101001000000001000000010100000001011000000010100100110
00010000100010110000100100000011001011001110010000000110010000100001100000000000100000100001110011000
01100000000000000000110110000000100101011000011001000101001100100010000000010010001110000100100110011
00110100100110000111001000010100000101100000001000000001010000001011000100011110010000000101001010000
00101000000110000010000110011100100100000000101110101000000001000000010111001101001110101110010110100
10001000010001000000101000000000100000001010100000101100100100010100000011100000110001101100010000010
00001000000100010000001000010111100111100010010000011000001110111010000001100001000110101001110010000
00100100000001000100000100010110010111000101001010101001110110100000001000100010101000001001011000010
10100001101010100000000000000100011001010101101100001010010010010000000110101110000001000000001011000
00000001011000010001000011010010010001001010000110000000000001000010110000001010001000001011001110000
00101001000100100010000111010010100100010111011010110001001100001000010001001010011010000000010100010
00000000000011010000011010110101000110000000101010100001110001010000111100100001001001010101001000000
10100001001101001000000001011101000000000100000010000011110010100101001110001000100010001101010010011
00010110100100000010000000110001000001001000111111000011101001101010100001000000100000101100001000011
10000100100000010100001000111000100101000100110001110000010100100010001101011000100110000001100001000
00000111000101001010010010001010000000000000100100001010000000110101010100010011010100100010100101000
11010000000100010100101000100000100001000010000100100000000111000001000001100000100000010010000110100
01100001110101100100010010110000010001000000010100000000000000100111101110010011000001011000110000100
01010111100010000010000001000000111001010100000001000010100100000010100000000111000000100000001001001
00000000000100001000110000100001010100011010000011001011001000110010001000100110101110000000000110011
01000010000000001110101000100000001011110100000000010010000100100000100000010001010000010010000000100
00011100000010100001111010000000011101001001000010000000000010101000000010000000000100101001000000011
00111100010010101000000100000110010110000000000100100000010000000100000001000110000100010100001001110
00100000000000000111001010010010100110000000000001100000101010000000000110010010010010000000010101000
01100100011000000000101011000111101000001000001001000000000101001000100100010010000001010110000000000
00100010110000010001010000100000101000100000010101000000010010000100101101000101100001010011010010111
00101010000010110000011000010010001110000101000110000000010100011000100101000000111000100001010010000
11101000000010000000100000000000010010000111000010010000001000110100010110010100000000000000000010100
11000010100011011000001010100010011001100001001010000100100001110000101100000101010111001100010000010
01000000000000000010100100001101001101001000100010000000100010000011001100001011100000000000000101001
01011010000111000000000011100010100000001110000001000110000000000101100010010010101100101000001010000
01100100010001100010100000100000001010100010000000010001001011101110000001000010111110101001101100100
01101110101010101000011010001000100110001000000011010000100000000000000011001011000000011001100110000
01011010110000010011000000001010000000101000000101000011011001000000010000010010000000000001000000000
10110110000001101000001001011100001100001111000010010000001010001111100000100010011101010001101011010
00000100101010000101001000110100000000101011000010011100010011011000111100101011100010000001000010001
00000100001001100100011110001000000000000000010101000000001001011000110100001000101010110110100111011
11001011010000011100010110100101000000010011000011101000000000110110100000001000001000000011100111000
00001010110011001011001100000001000000000101100100011101010001010010001000100001000000000000011000010
10110000001001010100001000011000000000000000100001101010010000100000100110010100000000100000010000011
00101101000011011000001001000011011110100001100110000000100100100000000000010001010110001000001000000
10101000000101001010000000101100010100010010100010110001001000000011000000000000000000101000010001000
01000000000000000000100000010101000000011001000010000000010000110000010100000000000000000010011110010
