00001010010010000011110001000010010000001010000111100110000000000000100110111010001000001001000000001
01100000101101011000000010010000000110000101011000110000000001000011100000010100100000000000000001010
00010011110100010011101001010010100100000000100010010010000011010000010100000101011110000001000001000
00101101100000001000011011010101010011000001100110000000000000100000000000010000001000000010010000100
00000010001010000100100011000011000010100110000000000101011010000111000000001111000000000000000100010
00000110010000000110000001100100100011101100000010000000010000100000000100001100010000010001110101100
00001000000000011000000110011101000011001000100000011110000000000000010010000011000001011101011001100
10100110101000000001000010000000001001110001000001100000101000000111010000001101001100000100011110011
10011100101000001000010110000110010101000000000010010000111001000010100100000000000010000000001000001
00000001000000000110000001001001001010001000010010101100011010000100100010000100001100000011101000101
00001001000000000001010000011010000100001011000101000000011010010000010000100000100010000000010000000
00000001001001110011000010011000011100001000000010011001100011000110000001101010101001100000010100000
01000011001000110000000110101000000001000010001000001010001000000110001000011000000000100100001000011
01001100100001000000000110000001000000011000010111101000000000000000000100010100100100001001111000000
01000011100001000100101011000001000001000010000000010000000100101000001000100000010101010110001101001
01110101001000000000100000110110001011100001100000100101010100000100110000010110000010100010100001000
01010110100001010100010000000000100101100000010100010000000100101010000101100100010010001000010000100
00100111011000110010100101000000000010000000100000100000000111010001001001000010100000110100110001100
00111100011001010101011010000001000000100001101001000000101110001111010000010011000100100000010110000
00001100011000101101000101000011000010011100000101010100101111100000001000001010000010000000000010010
00001111110000000000000001101100010001000001101000100100000000100000000000000110000000010100001001000
00001000000010100000001100010011101110100100111000100100000010100000000001000001111010000100010000100
00010010100100100000011100000010001000011000000010101111110101100001010000000000100001101011000011000
00100000010100001001110101000010000000010001010000110110000000001100100000001101010011011000000010000
00010001100000011000000000100001000000100001110001001100000001000010010000011101000001000100001011010
00000000100110011010010000100110000010000011100101011101000000000101000000000110010000110000010010000
10010011100110001100000001011101011100001000010010001101000000111000100000001000100011010010101001100
00001000010000100000000010001000111111100110100110010010001100000000000100010000001001001000100000001
00111001000010110100000000000000010010000000000101000001000000011000000001100111000010001010110011000
00001000101010001010100100001010000101110000110100000000010000010000000001100010110010000000010010001
00100111000000111000000100111000000010000000000001110001001100010001000010000001001100000000001000000
10001000110000001100100110000000000000110000001010000111010000001010000001001100000010011101000100000
00000001100111001010010001110110110001010100111001000000000010111000001010110011010000000010110000000
10100011110010010010000010000001001010100000010000001000000000000101000001000001011001010011100110010
00100100000000010101100010000011000001000101000000000000101000100001110000111100000100011000000000010
00010000101000000100100111100100010010000000001000010000000100000000000101001010000100100000010010001
11100000010001000011000001100111010001100000100101001010000001000000110111010000000010101111100001001
11001010010001100110101011010011000010000100000000100010001000100000100000111010000010100001010001011
00011001000101000100001001000110000111010110100001010000111000110001011010110001000000111101010001011
10010000000001000000101010001001100011010000001000001011000000000001111010000010011100010100100001111
01100110110000010000000010000010100111101101100100101100000001010000001010100001010000101011001100010
10101110110001010100000010000000000000000100110001010001100110000000000110000001000001000000100000001
00000000000001100000000000000100001001000011101001001010000000000111001000000001000010010010100010000
11001110100001000100001010000000101100100100000010010110000000000101000000110111111000001000001000000
00010100000010000011010011000110011100000100111000001100110010010001100000000100101100010110010110001
00011000001010011001010100010100010000111100000001100100010001100000110001100101000000110110000010010
00001010000100000100011101000001000001010000000000101011100000101000010001100110001101000011000000100
00100001010000000100000000101010110000000011110100010000110000000000000000010010100000110000001101000
10100011010000100110000100000000000000010000100101110000100010100111001001000000110000000000100010100
00010011110000000100011010100000001000101000001000110010000011110000010111000100010000000000000101010
00010010000100110100001110100001110101001000000000100001100000000010100110000000000011111000000010100
10000000100001000000000000010100000010110000001100001100010100101001000001110001011001001000010001000
01111000000010100001111100000000000011110000100000000000010110100001000001000100101001010000001100000
10001000000110001001110011100000100010100011011010001010100001000000001000010010000010010000000110100
01100101100000000100001000000011000000000011100001000001011101000000100001000001001011000010110111001
01000101010100100000000000110000001000001101010010000000110100010010100000001001101000000010000000110
11111101000101000000010100100100100000100000000010001001110000100011100110110100010000100000100011010
00000000000101010000110100001110100000001001001000100010001010101010000000010000010000111000010111000
11011010100000001110000011001000001010110001100000011001000010011101001000000000000001001000110000010
00000000011000010110110001101001001100010000100000011000000100000010000101000100001000000100010001000
01010000100100100101101000100000101000001000001100010100000000000000100100110111001000110000110000000
00000010000110011101010001000010100001100101010001010000010110000001000100101010110010100001000110000
001100010001010000000010000010000001010001011001000010100010001000000000111010100S1000001000110000000
00100000001000001000100100100000000000000000000000100000110001001000010110000000001000010100001001100
11100011010011000000000001100011010100010111100111000011100110000000010000010010001000001100001000001
01000000110101110100001000011000000000010001001000001011000010101011000000001100010110010100010000000
00101000011010000100000001010001100001000100010111000001001000100100011000000001001010100100000011010
00100000100000100000000100011011000010101000100100100000011001000100101001000001100100010011101010000
00000000000010001000001000110010000100000000000010000100010000011010010000000010100010001101111000100
00001000100010001000011010010100000000000000010001011000110000011001110110100100111000010100100000100
11000000000101100001100100100011000000110010100101000011011001010000001010000010110001100110010100000
11100011001110000100000010000101100011100001001110011001000001100000001010000000000101100000101010010
10100000000010100000011000011101000000100001000000100001000010000001000000000000100000000001001000000
01101101100000001010010001001100001000110000100110001001111011100100110010000001001000101000001100100
10001000000100000111000000000001000100100010111010000110001100011010010001010000000000011000000000001
00001011111001000100001010001000010000001100100010000000111000100000010000011000000110010101000000010
00001000100001011000000100000010000011000111100100011000101000001000011010000010000000001011100100000
00000011100010100011000010001010101110000000101010100010010100110000010000100001101000000000000010100
01010001001110111100011001101000000000001000000010000001010101001010000001111000000001001100100000101
01100110010100000000000010000010110000100000000000011001000000001010000000001000011001110010001000100
01101000000000110100000001100000000000110000000000010100001110000110100010100000010010100100000011001
01000000011100001001000001100000101100000001000110011100100000011101000000001000100100000000000011010
01110000010000010100000110000100010101000100011000101000001001000000100110000110001000000000100001000
01001001100000010000001000000100001110100010100010001010000111001000000010100000000010111001010000101
00010010101000010000000010000000100000010110001001001000010001000000101100001000010010001010010100101
01010000010010101100011100010010100000010011000001010101000000010010000001000000000010111100100001000
00000011000111001000100000000000000001001010001000000001000010000001001000100010010001010000000010000
00100101110001000100000000010100110011100101011011000000100001010100100100010001001000010101000000100
11010010110000000101011001101000000110101100000010000011010010000111000000001000101011000010010100000
10100001010111001010100000010001110111101001000100101001001001110000000000001000100000010100100011010
00000101010011110000100000001000110100000010000000011101100001001101110100000011011000001000001011100
00010000011000000000000000100001010000000000000100001001011000010100000000001000111000001100000000001
00000110100100010000000010001110100001010000010011100001110001010000000011100101001000000000010000000
00001101000111000000000000011000100001000000001101100010001001001010010110011100001001000100000000001
01010100001011000110101100001011110001000000100010000100000101000000011000100000100010010010101010001
01100000101010000101011100101000101010000100000000000010000000111010000001101010000000000010000001101
00110000010110111000001000110001010001010000001000010100001000111000100000000101011000100000110000000
01000000010000000100010000000101010000000011000010000101000100000100100110100101011100000010000000111
0010010001000100110100101000101010001000101011000110001001000000010001110100010010G000001101000001010
00010010001000001110110000000010000111000011010000001001001001000001000001001100000100110000010101100
00100001100001000010100000000100110000101011000100001000000000000100000000100111010011010100001010100
