00001000010000000100001001100000010000000010000000101100000100101100010100100000000000100000110100001
110010011000000000010000000001000000000000G0111010001100000111000000000100011001001000000000100101010
00001001001001010001010001101100100010100000011011001110100000111100101000001101110010110100110000001
00101000000000001000000000001010010000000010000000000101000001101101000000011001000100011010000100101
00000000000001100001000000000101100000011011000110111010100000000100011001001001110000001110001000000
00100010000000011000000001001110000100011010001000001000010100000100000000000001000011000100000101010
01010010010100001110000000000000111101001111001000000011000000011000000000100000000000000101001001000
00110000010010000000000010100000000000101010100000101000001000010001100111001110000100001111100111010
00100100000010001010000000001110110101010001000000110010110011101001001010010010001001001001110000100
00001110010011000011100000001000010100011000110000100000101001000000100001010101000001001000000000000
10001000000010001100101000010000010000001110011001011110000100000000101101001000010000000001101101001
10110010010000001000110010101000000100011001100000010100000111011000100000011100001000010100000000000
11000000101010011000000000000001000000010000100100010010101010010010000110110000000010000010001011001
10100000000010100010100000101010000000111100000011000100100001100010000001001100001000101011011001100
00000111000000001011000000000011001010001101010110010000100000000000101011001101010010010000110011001
10100000100100011110001100000001010101000110000101100000000010110001000000000100100000010001000001000
01010000000101100000000011001010010001100000001000110111100000010100000101000000000000100001000010100
01010010110110001000100000000000010100010010100100011010000001000001010000100111100010000110000000001
00001001000001011100010000100000011000000000010010000010100000100000001000110000000000100000110010101
10011001000100000010011000011010010000010000000000100000010000100001101000000000010000000100010011000
01011001011011010010000111000110010000010001101110000010110000000100111000111100100010000011011101000
01000000001000001100101001000001000000000000110010111001000000000000001000010000000010110000001111000
00011010100000010010011000011110000001011011101101000010000000000001001001000100010001000101110011010
00000001001000010000000001001000000001001110100011110111100000100001100110001110101101000000000101001
10000000100000110000011101000000100100000000010000001100010000000101010101000100100100000000000001001
01000000011100101110001100000001100000010001000000010000001000000001010010101101000010100000001000000
00010100100011100010000010000000001001100110100000100001100000110011001110110000001001111000001010110
01001000100010001000000010000110000001101000010001000011000001001010000010100001101110000101010000010
00000110001000001100001101001000010010000001001100010100110000000001100100010001010011110001100010000
00101110011001100100000101100100000001001000001000000110000000011001101000011101110000001000010000100
00010000100010010101000000100010000000101000100100011001000101100000001000100001001000001101010000001
10110000110000010000100000000000010010001100100000101101011000011110110000000000000110100000001100000
10001100100110010110110000000111000001000000110010010001000010010101011100000000000001100000101001111
00100011010100001110100100100000000010000100010010001100000101011000110011100010000100111001100000001
00010000100010000000000000001000010001000000010011000100000010010100011100101000001011001100100010100
01001100100000110001000001000100000010100100000001000100101010000011100000100010100000000100000000000
01001100001100101001001001100100011000001100011101000010000101001001000000001000000000010000001010010
10011110010001000101100101010000011100001000000001010000101000110011011000111011100001001010010000110
00101100010001011001000011101000000001010000010100000000010010000001000000000000100001100000000101001
01000101011000001011001100100011010111001000111000000110101100101001010100000011000101110000101000001
01001111000101100000000101000100010000000011011110000100000000001101100000000001110101100001010100011
00000110010110001000010001011100010001000000100100010110000010000100000010100001010011100101000110000
00001100000110000010000110100000001001100000100110010000001011010000000111101001000100000101011100000
01001010010000000001100100100110000001001101110000010100000100111100001101001001000010000000111000001
01011000100011000010000110100100000001000010001000000111100000011000101010101000000000001001010000010
10000001000010000110000000000000000000000100001000000110000010011000000000011011000100100100010000011
00110100000000100101010100010001000001000010000001000001010010110100000001100001100101000110001000101
00001000101010000010000001000010010111000100000000000100000100000100100100100100000110101001001100011
00000011101011000000000100000001011000000110110101000000010000000110001011000010101001101011000000010
10100000010000110001111000100000001001010000000110100001001000100001001100101001010001111010100001001
11001000011010000000011011001001000101111000000101010100010010110100110010000001100000110101000000011
10010000010010100000000000010000100010010001000000100011001000110110010010110001110010100000000001000
00011010010101111000001010010100000100101101001100000000000111100010100101011100100110000000100101010
00111000100000010001100000100101000000011100010000000011010100100011000000000000100000000110000110010
11000000001101001010100010000100001010100110010110010011000010000000000000001001001000010001100010001
11010100101110000000000100111100000010000000110010000001000000100010000000010110000000000110010000100
10011000110010001000000000100001101000010110100000100101000000100110011011011000000000000010010011000
10100000010000000000100000010000100000001010010000000001010000000010010010000111001100100001010100000
00010011110100010101011000000100000011010010010000011010001001101010000011000000011010001100100110100
01100000000000100000010010000100101001000011111011001000010001001000101011000111010001011000001000000
10001001011110011001100101010010000000001100100110010010000001100011011010000000010101100001010000100
01000001000011000010110010000100100011010000110000000000001010001000000001000010000000000001100000111
10011000000111000101101010000001100010100100010000000001010100000000000111001001100101100100000000001
00101100000011101000010000000000000101000100011100110010000010000001010111000110110001000010001001011
00001010000001000110000000001100100010111001000000000001000010000000001100111100110010011000010000001
01000100100100000000000011000000000001010111000000000011000110010011000011010001000110000000100100110
00100100000100011101010100110001010000100100010110010011000011001000101000000011010000100010101101100
10101000001100011101001100000001000001110000000001100110000000000010000000110111101001011010100100110
10010001110000100100000000000010001110000000110010011100010000111010100001010001000101000000001010000
01000001000000000000000000100000101010011011001000000111000000100001001010000000100010000000000001101
00000011010100011101101010000000011100010010000100010000100100100100110001011010001101100001101010001
00001000000001000001000100101000000100000000010000000110010000010000101010110100100100101001011110100
00011110100110001110100010000001000000010011000001001001110110100000000110010001000001110100100000010
00100001100101100001010001000111000000001110100000000001001110010010111001111000010000010010000011011
00110001001000010011000000001010000000010011000000000001000011010001010000100000010111001001000000010
0011000011001001000100000001010000110100000001S000000001001101000001010000001000000001001010010100000
00101011011010101011000001000010000111000000000000000100000001001110001100111000000010000001001101000
11101010000000111000001111011010010100110000100000011001010000100011010111010000001100010000100000001
01010001000100110111011000000100011010001011100001000100000000011011001000010100010000000011000010000
10101000111010001010000000010010100101011100000001000000010000110001100000110010000100000101001001010
01000100000010000001000101000000100110010000010011101010000100101001010000011100001001000010000100010
11000000001001010000000010100010000010100000000000010010000000100001000000100000010101100000001011101
10000001011110001000001001000111100100000110000101000010000100000100000000100100101010001100100001000
11100000100000111000100011110110100010111000001000110001000111110000100010000000001000011010110010001
00010101011000101010110001101000001110010000001001100100010101000000001111000010000001000110000000000
10000100000010001000011100110000000001010000101000100000000001011010100100000110100001001000010111000
11000010101100011000000001110011000010100110000001000000010010001100000011000100110100001000000000010
01000000000000101000000100000100000101000000000101000000110110100000000000000111100000000001100000000
00000110011001101000010001000000000000010010101100000011010100000011000001001000000011001000101000000
00110000000101011000000000000100100110100011001100000001010110000001011100000100101101010100000000001
00001010000001000100101010100001010011010100001100011000000001110001001000010000001000110001111101000
10100110010100011010001010010100000001000000010000000010000011110000010000000011000001010010111000000
10010100010001100011000101010110101000100100010000011000100000000001010110001111010100010010000000100
01001001000101000000010000001000100111000100000000001000110000110011101101110000001001100000101101001
10011010000111100000100100110110110100101010101000010011011100011001100110010001000101100000011101100
00011110000011101001000000010011011000001111100000001110100010100001000000001100010000000010000001101
00000010001000000010000001001000100000110001111000000010010000011000000010000000101001010100001000010
11000010000100101000000000010100000011000000000100110100010100000100000000000101010000000001000101000
00100000000000000001001001011110000110111010010000010110000101100010000010000110001000000100011011001
00000010001001011110000001110110101100011000000100001010100100011000001000001000010011000000100100001
01000000100000100010010001011100001001000100000000000101100000011000000010000110100000000001101100010
