10000100001000010000110100100001001001011010001000010000010100100001000000110000011001010000000000000
10000100110101000010001000000001001000001000011000011010000111100001000100000000000000101000101010001
10000010000000101000010110000100000110000100001110000000000101110010011010010100010100010011111000000
01100000000000001000001000001110110000100111010011001101000110010010100000001000110111000000000100010
10100001010100000010000011100000000010000000001000111000101001010000000011001000000001001100000000100
10000010111000110110111000010001000011001000000000010000000000100110100010000100001001100000000011111
10101010001100010000000101001010010101011100100001001010111010001110010010100000010000000110010000100
00010000000000001010100010101000001100000000100000101110001010001011000100001000100110111000001000000
00010100000000000000100010110001001100010100000101110000000010011010101000000000000001001100111001000
01000100100000000000000001000000000010101110100101010110110100010010001000011000110000010001100110010
10101110011000000000010010001100000010011010011010101000000000100001010100000110010000000001001000110
00111100010100000010010000110011010001010000000001010000000001010001000000001101000000100000000001100
00010000000010111011011000100000010001001010010000010000000010111010100000100000001011010000000110100
00010001000100001001000000000101000100000100100001000100000000100000100101000000011010100001000000101
11110010110000000010000100010000011010000001100000010000001000101100000001001100000001101000000000010
00001100101001000101000000001001000000000010001011100000111000100000001000010000000101000000110010000
00000001000000101000100101100000001000000011000100001100101000000000011000000110000000000000010000100
10010000000001100000000001111100100100010100101000000000101011100000101001001101101100001111000110100
00100010100001000001010001001010000010110110010001000101110100000000010000111100010000101000000011001
00010010000000011011100000000100100001000001100100000010010000010000000000101000000010001101000100010
01001101001000010001000000000100001010001011001000011110000011010101000100000000101101000001001001001
01001011001001100001010000101001000001000001010000000110000010100101000100101001000000101010001100100
00110001101001101100110010011000000000000001011011100000100011101010000111000001100000000100000100000
01010000000100110011001000001110101000000000000101110100111000110011010101001010001000111100101110000
11000111001001011100000100011111000011100100100100000000000101001000010100001000100101011010000111001
00000100001101000010000110010100010111000000110010100000010001000000100001100000111001110101010010010
01101010000000100001000100000010110100000000100110000010110000001000001010000010000101011010000100010
11111010000000010000010010001111000001011000000100000001010000000110000100101100000100000000010110000
00100010000001000100100100110001010001010010000001001001000100100001000010000000011000111010100000000
10100000010001100000100000001100100001100000100011010000100010011000111010000010000001001010001000100
00000000000110000001010111100001001010000001000110001001010101100111001100100000001000100000100000100
00000110001000100010010111000000100000010110100000001001110000101100010000000000110010010100100000011
00000000001000001100110000001001000100000010100000100000001000000111010010010011001111010101000010000
01110010101011100111000011000110011101101100000000010000010000101110000000110001010000110000111000000
00001110101100000010100101011000001100000101110010000010001101100011110100000010011100100000010101000
10000000000000011000000100101111100010010111001001000000101010001000100100100100100110010101101011010
00000001000010100011000000101100010010011000001000100011100000001010101100010100000010001000000011100
01000010010110101010000011000000000010000001000000010100000001010000100100010001000111011101010110000
00101010000010001010001000001010011101001010001100001011110000000010010000110110001101000010010001101
11011110101010001011000000000000110010000001000000100010000000010010011011000010001110011000000010100
00100000110110010010011000100000000100010000100001100000110000100001101010100000000000100010000000001
00001010010000000011100000011000000111101000000101000110000110100110010110100101100100100010000010110
00010010001110000110000011000010011100011100101000000110010100010100100000110000000111000000110110000
10000000000001000001000000010001001000101110001001000010000000001000001100110000000010100000000001000
01001000001110000011100011000000100100000110111001000001101000010101110011000010001101001000000000000
00100010001001101000000011011011101001110001101101001100000110010101010111000001010011100000001010100
11110001000010000010000001001000001001101011000101000100010000100000011100100110011101100101010000011
00010110000100111100011001000000000010100111000100001100001100010000001000000000100110110101000000000
01010101010001001010000000010000000000000000010100000101100010100000010010100010011110101000011101000
01000001000000000000010010000001001010001001100110100100000100100001001010000000100001110101010111100
10001000100001101001011000111101010000000010001010000001010010000011010010100000001000001001111101011
00000100000000001111001100000001000000100000110110011101100000000000011010010000000001000111011000111
10000010011101011100000000000100000000100100001000100000010000010001000100011000000101010001000100100
10010011010000010000101010100000010000110100000001010000000000000000001101000110000000000001100110000
00001000000010000001000100110010101100001010010001110110000000000010000100110001100101000100010111001
10000000010011000001000000000001111100010011000001100100010110000011000001110010001111010010010100000
00001010001010110001100010001111010000001010000101001000110000000011110011100000101000010000110100000
10001000000000000000100000011000000000000010000101001010110011010000010001000100111001100000110000001
00000010100000011100100000110001110011100001001100010110001111000100000111011101000101010010000010100
01001011000001000101000001000010010000000100000110010010010101010000010000010100100001110011101010100
11010010100000000110000010000000000000100100110110000111100000110000000001010001001111100111010001111
10010010000101000110000000000000000100001000011001011011101010010001000100001000100000000110010000000
00000011000000000000001011000001000100010000010110101001001000000000001000010010001001001000010110100
00000001000100000011000000100000011000000010110000000110000010000100101010000000010100010111011010000
01001000000100010000000000101001000000011001000000100001000111001000110000001001000001100011010110000
01001001000110000101000000010000000100011010010000000101110001100001000001000101001010010000010000001
10001001101000001001010000100000100010001000100000010000011001000000101000110111011000000000010000010
00001100101000010000101000001000100000000100000000000000010001010000001101110010000010010100000111000
01100011001011011000010111001101000000110000000000110100110011001111001100111000000000000101001000000
10010000010000100110010000001100100100000000000101000000000000001011000010110011000000010010101000000
00000000100000110111101010110001000100100000000000000001000111001111000001100000001000010000001011000
01000100010000111011010010000000000001100100001000010011010101010010110001010010010010000000001000110
111010001101000010100000101000000010000100100000001100010000010110011000110000000111000000G1100011000
11000100100001010110000110100100111110011000100100101000001101101001100100100000000000011011001000000
10001000000000110000100010010010111110000001100110000100010000101000000100000010100100010110010100100
10000001111001110000010000010001001000001100111000000000001000000010000000111010000000011001000100000
11011100100111010110000010101000000011010010000001101000001000001111110011000000100001100001011000001
00100110100100000100000000000111010000100110000101001000000000000110011001000000010010001000000010000
00010100000100000001001010001010111001000000000000100011001001001110000001010001100100011000010110101
00100001000110100000010001000100100100000011000001001010100000000100000000011010000000111001011100000
00000001000101100100000000000001100110100000111000000011000100000101110010010110S10000001000000000010
10100000010001011110101011100011000001100010110001000010010101010100100001001111001000010100001101000
10001000001000000110010001000100000000000011001000001001001000000011101101000010101110000000001000000
00000101011011010100001000000001100100000010001010110000000000010000000100000001000111110001000011000
01000101010001101000001001000000101010100001100000100001010000000101000000110000000010000100001000001
00000010110000010000100100101000001000000110000000000000000000001001010000100000001000000111010001000
00001001100010100010110011011000000000010010000001010110001100100000000000101111101110001000010100111
10000000010010110010000000001101001001100010000000100001100001101100100010000110100000100000011010000
00000011001001000000110000000001000001000000101010001110000000010001001110000100010001110100000001001
10010001100000001011101000010001000011000100001010011000011000000101010100100001001110100011010110000
01010000100000000000011110000011101000000101001110101000110000010111000010000000001001001100000100010
00000010000001000111000100001001001001000110100000110101001111000110110011000100011000010100101001000
01100110010000100100011000001000010111000001011000001000011000000000010000100000001100100000011000010
00000000010000101001001010101000011000000001000101100100001110000001111000000110100010100101101010010
00001000001011001110000010011000011001110111011001110111011000010010001101000000000011101111011100101
01100011110010000001010000000000111100011100010000000100010110110000101001001001010001000101111000100
11101000010001001000001101000000100100011100110100110111011000100001011000001011001110100001000001011
00011001100001000000001100001110001100111011001001110000100000000100001100010000000010100101001000100
10100100010000000000100001011100001100010000001101010001010000111001100000000010001100000110001000100
00100000101011001001100010110001010100000000000100000000111000000100001010000000000011110001001101000
01010100110010101101010100100000010010011001001100110101100000000101011111100000000100101010000001000
