01010110010100001000101000011010100100000001011000001000001111100000000001100000110001010010110010000
11010100010000001100100000001000000000100000101000000001001110000010000000001010000101010000011010000
10110110110000001001011101111010101000010000000010010000000000110000000100000010000100000001000000100
00001010100111010000101101000000001010010001011010000011010101010000110001000100010011110110101000000
00001010101010001001010010010010000011000110100000001010000100110010001110100000000001000001101100101
01000000001000000101100001110001000000000100100000101000010000000000110000011000011011000001110011010
01010001000000000100000010100000001001000010101001000110000000010001000000110000010000110000110100100
00000001110000100000100100000100010100000000101110010000011001000000001100000000110000011000011010000
00001001110110010010000001000000010000010001000010101000001000010111011000000000001100010000000101000
01100010000000000000000000010000100000000001000000000000100000001010100000001101010000000101000100010
01010100010000100101001100001010000010101000000000000000101100001001011100000101000000000000010100010
00110101100001000000001010010001100010000000011001001010000000000100001000001010111000001110001001110
01000000011001000000000000100011100010000001011000011101000110001111010011010000100100000001000101100
01010001000111100001000100000000001000000010101010010000010101000000011001000000010000101101001000010
01001000000100100100001001110000101100001000011110100101000000010001010000000010100000000100000000100
00010000100111000000100000000100001001100101001000011111101000101000000000000110111000101000000000101
10000000000000001010100011100010101000110001111111010100100000001010100100011011000000001000000010101
00100000000010100000011001000000100000100001011010100100011001010010000011011100001000011000110010010
00001110010001100101010010100100011100110000000000110010100000101010010100001110111001100000010000000
10001010010011010000000110000001000000110010000000000110111001100000000100100000010010000001000001101
01111011100000010100010111100101000110000000101100000000010011000110000010000011000010001011000000011
10000110011010100000000100100000011111011100000111100110011100010010010100100101000000010100100000101
00101000110100000010110000000000000100011010001011101000010000001000000010100000100100101000011100101
10000110100000000101010111101100100001100100001000000001001110000000100111011010000010100111100010000
00101001000001101010000000011111111011001101001000000001000100100000000001000100111010010000000000000
00000000000101100100001001011110010011101010000010110110000111100100000100000000110001000010100010010
00101001001100110011101011001101000000001011011011010000110000011000000010110000001000000010001000110
10110001000001000010000001000000001001100000100011100010010100001000000010000101000010001101010000000
01100100000000010001010000111001101001001001000100001000000000011001000000100010010100000001000000000
00000000100100000000111110100110001010100100010110000100010010011000001101110001101100000010111000110
10010000000010010000100000100000000010100010000011010011001000010000011000101011011110110111001000000
00000011111011110111101000000110000000100101000100000100011100000001000000000100000001011000000000100
01101100010000000001000001001101000000010111000101000001000000000011001101010000000000101000011010010
00110000101000110011110010001001000100010001010000101100001101100000000000001000010100011100001000000
01000010011001010000101010010001010100000000101111010000000000100000000000000100000000011000101100001
11011000000101010010000100000100000000010010110010000110010100000000101001010100000010100000101101000
00100010000010101011000110001000100000100001000110010010001110101001101010001000100001100010100010001
00000001001010010100100000000000011011011001100000100010110100011110001100100101001110000101000001010
00010010001000000100110001001000100010011100001000010001000101110001001110100101100111111100000101000
10000000100001000001000001101010000110000011010101001011110010000101100000111000010000000000110011001
10100000001000110010000110001001000101000100000000000000001000110000000000011001000000100011001010100
00010010000001000001101000001000001110111000011001000000100000000010000000000000001000001100000000111
00100000100010010010000010100000110000000000010000100000000100110001000111100000010000100100010011001
01100000011001000100010101011000000000000110000001110000110100010010011101000011100000010101010010000
00010000000000011001000100100100011001000100001000000110000100000000101010000111010100100100010000111
01001110011001101000001001101010000111000000011000010000000000011001001100001010000100010100000000011
00010000001000000000001110000110001000000001100000010011001100001100001001001000000011010010110101000
01100010000000000000000100111001000010010100001000011000100000010000001111011101010101000001000000000
01000000000110001100101100000010000000111100010100000001010001100001001111001001000001010000101000010
00000000110100001010110000010010110111100100000011000000010000000000110101000000010101001000010001000
00101100101000001110001010001010000001000000111100001011000010100010000101001101010110001000010010010
11010101000111001001001010000110010010001100001100100100010000000000000101000110000101000001001110010
00100000011001010010000100100000000000011000000100001000001001000100000110001000000100000000100000100
11000100010010110001000010101001110010101000001001100111001111100001100010010001000000010100000000100
00100000001111100000001101011010010000001000000001101010100100011000010100010001001101000111000010000
01000000010000011011000111100000000000000101100000000100100000011001001001010100010010000000110111110
01101101010011101001000000110010000010000010001011010000100000011010000011000100000111000100010010101
00000011010000000000011111010000001011100000000010000000100000100000000010000000000011111100001100000
10000000001001001100001010010001000110010000000010000000000100100011110100110010100111011000100001001
00000110000001110000010000110001001001000101001100101100110110010010010000001000010001000110101010110
11100000000000000110001000000010000101000000000100010001010000000001100001010100101110100010000001100
01010001010001000100000000100010100010000000001001001000011000100000110100001000000000000001100000001
10001000100001010000100000100010000010010010001000000000001010001110000000000010000110100101000000100
00000000000000001110100000000000100101101000100000000100000100001000001100000101000000001100000000011
00010010110000000100001011000001000010000000001100110010011000010000000000001110011000000000100001000
10000000010111001100100010001000000011001100000010001001000000000000000001000011001100001000000000000
11011001101001010000011011000100001001000010010110101011100010000011111010100010000100110001011000000
01000100011001100100111000000000010010010000110001010000000001000100100100000001100100000000111010100
11101000000101000001010100001110101000000000100010000011110010101001000110001100000001100000101110000
00000001110100001110100010000000000000000000000000000100010111001000101000101000100100100100011001000
01000000001010000100000000000000100000000000100001001000001110000110011100000011000000100010001001100
00000100000010100101000010010000010101010111000111110001010010000110100010000000010000010001010100000
10110001000010001000110000001000100111000100001000101000010001000001000010001100110001000000110000101
10100000000010101110000011011001000011100000101000110000000001010001001101010100100100001000011110001
00100100100000100000100100111101000110010110010101100010000001010000010001001110000010000011000000100
10101001000000100000000000010010100000000100000000000000011001110000000110100100100000000000101000011
01001100011010000001001000000000001010010010001000110010111000000001011101000010010100100000101010011
00101010000000000100000001000011001001000000010101100101110000001000000010001100000000100010000101011
00001010100001010100000000100100010000000000110000100010000000111000101100001000000000000010000001000
10001100000000010000100011001110100000010010010001011100001001001000000101010100010110101000111100001
1000011011000011100100000001101001100S000000000001001000000001100010010011000000100001100010000011000
01110010001000000100101000000011010001000001000010001000001000000001001000110000001001000000001010110
00110000110101110100000011100000101000100101001000101010100001000001100000000100000000011000101011011
01000001000111000010101010010000000100110001001001100110010001011001001000000000100000100111000000100
00010000011000011000000100001001000000001011100000001000000110100001101000011000110000101000100010111
00000101101100100000110110000100111000000010001001000111000000011000010100101000110001000011001001000
10100000001011000000000001100000000001000000000000100001101000000000110100000011000011100110001000000
11101000010100000000101000000010100000000000000010111110111000011000101000011001100000111100000101100
00011100010000100011100000000101100100011000101101010000000000000000100010000001000100011011000001000
01001011110000001100101011100000000100011011001011000011100001000000000010010010100010101001000100000
10100101000000000011101000000000110100000100000011100000000001000000100101100000100000100101001001010
00001100000000000001100100101100110000110100001000001111001000010000000000100000000000000100001000100
00001000010010000011010000011000001100100000000100000110110001000101000101000001010000001000010000100
00010000000101000000010001000001001000100111000010000010001000101100100000100000000000000010000110011
00010010000000010101010001011100000010110010010001000000010011010100001000000010010000000011100100100
00111000100000100001100010G10000010000001000000001010000110000000000010000100000000010000001001100000
00011001010001000101010010001100000000000000000011101100000101000010101000110000000100000111000110101
10001100100000000100000000010010101000110000001100001010001110001010100010000001011001001101001010000
11100000110001001000100001001010000100110000011101001010010000000100001110000011111010110111100010110
00000000010010000000100000100010110000001000010000100000011000000000010100101010101001011001100001010
10000000000000000100010010001000010000001100110010110100011101001000011010110001011010110110000110000
