01010000001101000010011000101010000011010001000000001100100000001000001000001000011100100100000100000
00101011000010000100010010001110000000011101010110001111011010100000000001011100100100000000100000000
01101100100000000000000001000100100001110001011100001001100001010100011111000011001000000100111000010
00000010000000110000001001100001110011000000000100010000001000100101000010000011000011000001001010111
00000100000000100111010110000100000100000010001101010101000011000000000010110111000100001000000100010
11000010000011000001000000010010110010100000001001010000010000110010100000100110010001001001000000010
11011001000100011001100000100001010100100001100001010100000010011100010000000000000100100011100010101
10001000000000000000000100000000101010000000100000000100000011010010000001011000101100001100100010001
00110000000000100011101100111000000000001101101000001000010011110100110100010010111010110100000010001
0100000001000100001010101011000010100110000000111000000001110100010001000100000101010S110001001100000
01001001000000010010000100000101110000000100001000000001000001001010000000101000001010110000110001010
00000100100111000010010010010001001000000010001000000101000000011000010110101000000001010000000111000
10101000100100010010000000001000110000000011000010010010100000110000000010011111001100110101100000010
00000000100111010010001000110000000001100001101001001000001001101100000010011010000000010101000100101
00100001010100001000000001111011100010100000100100000000111100100000010001010000010000100000000001000
01000100111010010100010000001101100110001110000000100001001100010110100001000000000000001010010100110
00100000100001001110010010001010001110010000010111010010010000100100111001000000100101000100010100001
00110000101111001100011101000000010000001101100000000100100100001000000000001100010000111001100000010
10000010001100111001000101110111000000001001010000101001000000011010001000000000101001001101100010011
00000101000101010011001001001001000010111000000000000000001010001100001000100000100000100001000010000
00000010000010000000111001000000000001010001101000000000110100001100000000100101000000000000001001010
10101010000100010010010000110000001010100110101000000100011000001100111001100001000100110010000000001
01001011001000001000010000000010000011110100001010100011000010010000010000100000000100000000001001100
10101000001001101001110101010101000000100010100000011000000110000100110011100100100000001000000010000
10000000000010000011000100100100001100000011110100110110010000011001000011001101101100000000011100000
10000000000101000001101000101110101100010100000000001001010000000011100100011000101001000100010011000
01101010000111001000100100001100100010011100010010100001100000010000000000010001000010000111000010001
10000100001001000000000100000001000010101011100010100010100000000010001000010010010110000000000010100
01000000101100100000000000001100100000111000000001000010110110000000001100001100001000010110100010000
10100000100100010010010101000000000001101000100100000000000000000001000101000001010111100010100000100
10101000110010000000100100001101100100100100001000010100100000010000110000111001001000000011000001001
100010001110010010100000011G0100000100010000010111001101000100001001001000100100000100000111101000000
00101000010100000000101000001001111000001010000000110001010011100101011000010001000010011110000000100
01000010000000100000100001001000010000010000100000100001100000000110001100000001100000000000000010000
00000010110101101000100011000010010001001110011000001001001000100010010100101000100001010100000000000
10000000000001100110010000010110101000000000000001100000000101001100000101010100100100100010000000010
00000000011110001010000001000111000100101100000110010000010000011001000000101001110001000111001100000
00100101000001000100100001000001100100001010000010111001000010011000010011001000000010000011000000100
00100010000100001011101000010101000000000001110000010110010011000100000000000000000011010001000110000
00001001000001000011111110000000100000100000010101000010110001011111010011010000000100001000000000101
00001010100000000111100000010000011111001000000010101000100000010001101100000010000001000000000011110
00000000000110100100101100100101010000110000100000100000000001000001000101101110111101101000000000000
00000010010111100010000000000000001000100000000011000000000100000011010000010000101000011001000011101
00110000100001010111110000101011000000000010100010101011110000000001100000110010000000010000110010000
00000000111011000100010101000010100011011001000001100001000000000100010010000001000000010010000100111
00000000101010111100100000000000100010011001001010011000001010000000001000000000010011110001000001000
01111000100000010001101110100000000000100110100010110000000010100000101000000010000010101100101000000
00011001000000100000111010010001100000000100100001000100010010000100000001001110110101010110000010101
01100000110100000000010110100001010000111000110001000010010100000100000010110000001000001000100100010
00000101000011101000000101000111000001011111001000100110001110000000000000101101000000000100111010110
01000110000010000000000000000000100011100000011000110100110001010011001000010010001000000000000010000
11101010000000000001101000010010001000010001011001010000110000010010000110001000000001000000110101001
01000001000110111110000001100000011100010111001110111010000100000001000000011010010000000110000001000
00001110000001100010100100000010000101000110100110001100011100010010000011111111000010000000000001101
00001001100000000000000001110001000011010001000000001000101000000001101100100111000000000000110101001
10001011000010000011000010001000100000110110000100001111110100010001001100001000000001000000100010111
00100110100000101000001000000100101101011010100001101011001001000000101011001110001011000000000000001
00000001010111000110000011000101000101000000001010100010000100010000001100000000001011000100010010000
01011100001000111010001000010100000100101011101000000001000101000100001010000101000101010000100110001
11100001001000100000000010000001000000010001010010000000100000000101001011100001000000110000000100010
00000000100010001001000000010101000101001011100000100011000000000000110000000000001011100001010010101
01110011010000000000000000101000010011101000101001000001000000000100001000100010110010011010101110110
00000000100001110111001000001101000011110100010100010000000000010000011001110110101010000100000000101
01000000001100100000111000100101100110011000000000001010100100000101000000010000010010000110001001001
00010010111000010010000000000000000011011011000011001000011110010000001010000100000111011000101000001
00010000011001110000011000001000001001001011010011000000000010000000001100000100100000001000010010000
00010010100011001000000110011000010010001000000000110010001000000000111000000001010000100001000000000
00000011010000010010110000010010010100101011001001011010011000000100010010010000010000110010011000000
01100001100000000001101001110000000000001000000111001000100100001101001100001000111001000001010001111
00100010000100001000000000010000001100000100001010100001001010000000000010100100010000110100010100110
01001001000000000000110000110100000011010100101000000001010000000111001000010000001000001100001000000
00010100000101001010100011001010000011000010101000001100011111101000010110001000100000001100001011000
00000000000000101001000010001010101110000101000000111000101000100010111100100000111000000000001100011
10001000010100000000011010001000000100010101000010000110101000010000000110001100000011001000000110000
01000000010000000000000000001000010110000100010001100110000101000000111000101110000011000000000010000
01100011000100000101010100100011001000010100000100110010001000111101010000000001010011011101100001001
00001100000000100110010010111110000000100000001000100001000000000001011101100100000010011100011101100
00000000001001111100010000100000110010000001010010010000111000001100000011010010000000000010001010101
00111001101001000000000010001000011001000000100100000001000000000000011001000010000110110000111001101
00101001000000001100011101100011011001110101000000100000100000100000011010000100000011100000110101011
10011000000010110101001000010010111001101000000111000000010101101100001011000100000001100000001100010
00001001010010000000010001110000001010001000000010000100101100001110001101010111000000000010000110000
10010000100000010000100010100001001010000000010000100100010000000100001000000000001000011010000000101
00110000001001001100000010100001001000010011011000010000100100000110110110111000000101100100100001010
00010110000001000001000111101000110000010000010001010000000101001001101001011010101100000101100000000
10100010000000000100000001010100000100000000000000000001011000001010000000000011000011001000000010000
01010010101110000101000000000000001100001010101000001101011000101001000100000000000000100001111111001
01000010000000010011011001000000000001010001000001010010011001001001000000001100010000010010011110010
00100100001000011101001000100100010001000001101000000000000000100011000011110001000000011000000000000
10000010110010000000100000110100000101001110100110011000011010100000011010001001110000000010011001010
00000010100010100001110100011000100100100010001110010100010000000000000100011000100000100010101000000
01000001011001100000100011000101100000001011100000000000000001110000000100000010111100011010000000001
01100010000100111001100010010100000001000001010001100110100000101010100100000001000100101000000010010
10001000011000001010010000011000010011101010000100001110010101001010011000000010000010000000000000100
10100000110000011001010010000000000010000001000100000000001010001000000000110000000001000010100010000
10000001000000110000110111110000001000100100000001001001000100001000000100000000110000000000000011000
00000001100000111010110110100001001100001100000000100000100010101000000000010000001000100111000000010
11010101000100000100110011001100010111000000010000000000111110001000000010101100000010000000000001101
00100101011010001010000010000010101100111010110111000111000100010100001111000011100000000001001001100
01000001100101010000001101001010000100100110011000000110000000010011010000010100011110010011000000001
10100100000111010100001010000100111001000110000100000001100000101101000100001110000110010000000001000
