00000010010000010010000010000000000100000000010000100100100100010110010001011110011000000000000000000
00000110110000010001010010001000111010100011000110000010000000000001010111000001000100110000000001100
00110001011101010010100001111101100010011100001010000010100000010000111001100000000011001000101010010
00010010000100000010010001100000000000001111010100010100000101000000011001110000010110001000001000100
00100100110000011100000000000100001100000010010001100110111100011100101100100010100000100110011000000
11000100101000000010010101001011010110110001110100010000001100010010010100000010010100000101000010000
00101001001000000100000010011100000000011001000001101101101011000110010010010101011000001000000110001
00000011110010000101101000000100100001010000010000000010111000010110000010010011001000100111010000110
00001010010000011101000100001001010000101001000110110100000010000100011110010100100010010011010100111
00010000000001010010000000000101000100101011100000010010000000010000000101010001100010000010010100100
00100001101000110010010001100000001010000100011000000000101010111000000001100100001000100000100110100
10000110000000000011001100000111010000100000001100000001011101010000000000010000100100100000000100100
10001010000110110010000101100001001101000100000111000000000000000010100000000111100100001100001000111
00001001000000000010011000110001010001010000010011000010000000000100111001100010110000000000100010110
00000011011001110001011000101000000111001010100000100000011001001100100110000001010101111100010011000
01010100110001100000100001011001011000010110010001111010010001001101000100101000011010011101010011000
00111001000001000000000000000000000100010010110000100001101001000010000111010000101000011000000110010
10100001010010000010000001000000100010000001010010001110101011101010010000011100010111010010011000100
00111000000100010010000110000101001001100000100000000010000000000011000101101111000001000000011011010
00010000001100010001100010000100000100001110100010010001000011000000010100101100000111011000000001000
10001100000010000001100100100101011000000000100010000000100000010010000110100101000100110000000000110
00101011101001100100101110000011111111000010001011001100010000000000010100011010000000000100010000010
10010010100100000100011000000000000000000001000000100100001010001110001010010000000010001000110000010
00010010000001000000000111000010001011001010010010010000000001000000011000000001001001111000001101100
11000110011010100111010111000000101001011001110101000100000101000011000000010001001000010010010000011
00010110000000001010010000101101010111000100100000001000010100001100001011000010000100011000100001011
00000110110100000001010010000010101011000000010111000111100010101000001011000000001000101110000000011
10111001010000000011000101001010000100010100110001000000001001011000100001110001111000100010000000100
10111010100111110100000110110010000101010010011010110100101001100000000001010000101000001000010100000
1000001101000000001010100010000000001000011100000100011001100011000001S000001010000101110011000101101
00100101110101101010000000000000100000100100000001000000010000101111101000001010010101101000010000001
00001100000111000010000100011101010000110000100001000101000100000001010001010000100111000100010001001
10101001101001000010011101001000000000100001100010100001001000000000001100100001101001010101101000011
10001101110011010101011000001001110000000010000110000010000001000001111011000001100000100000000000011
10000000001001100000000000000101010000000001001001101101000000010001000001001000111011101101010111001
10100011000010000010000000001010011010011000010000000000010011000010001000100101000001001011001001010
01101001000100010001100001100000010010100010010001001100101111001000101000010000001010000101100001001
11001001010101000101101100100000111101001100000011001000100010011011100010100100011000010010001101011
11000000100101100100001000000101000001000100001001000000011010000000000001101010010001010001101000100
01100101000010100000000100000001010001001001100001000011100111000100001011000100100100100010000001001
00001001000001000010000010101000100001000001110010100100001100001000010100000000001100010000000101111
10011000110001000010001100000000101000000001001000000000010001000000000000100011010000011011000011101
00100000000000001110001000110000010000100001000100011000000100001010000001001010010000111010010000010
00000111010000000010000100000100000010011000000000001100001010010001010000110101000000100100010111000
00001000101110001000000100010010100110000111000101010100000010001011111100000010101001010001000010000
10001000100010010000011000100000011001110100000000000100010010000101010000000001000011100110000011010
01000000000000010010011110100000000100101000100001000010000010011101000000000000000001000101010111000
10101111000000010000001001000001000000110000000000011001100010001000010000100000000010100010011010001
00000000000101010001010000010000010000011000000100010100001001001001000001011111000110101100000001010
00000010011100101000000100000000100001010010001011000110101100011101011000011011100000110011001001100
00010100000101000001100100000101010001011010001100001010000000000100000000110000111010000100001001000
00101110000001010110011100110010001100000000000010001101000000001001100000000000011101010101010000010
00110001010001010001000000100111001000100101110011100001100000000001001000001000001011000100000000010
00100010011100101100000000110000000010010111011000000011100001000101101110011000000010100001010100000
00011000100110111000000000011000001100010000001000000000001000000100010100001101000001010110110000100
10000111010100011000001001000000000101000010000101110001101000010001011000000000110100000000000001100
00100010000001010000101000100000000100110101000100001011000011010000001010100001101000101110010100000
11000000001100000110001010000011000101010011100000000010001000010000001101101001001110010010010000111
00010101111001000100111100000010001000011000010001001100001000100010001001100000000000000001001001110
00010101001000010001000001000000010000000101100101000000100100100000101011000000000000001000000010110
00100100000000001100110000001001010000000000000010001100000000010010001001110110001000000111001001100
00011000110001100010011000001010101010111001110001011000100001010000010010011100100001000010000010000
00111001000010110111001100000100101100110011100101011011001000101000100001000110101001000000010001000
10011111000001000000010111100110001001110110110100100001101000000000010000000101000110101010010010011
00100000000000011100000010000001000010000101011001010100010011010000010101000010000011001110000001000
00000110100100000101011000100001000111101001101000101001000000110000100110010100100000000000010111110
11100000010110001000001000000111000001001001000000100000001001000011000010110001100100100010000100001
00000000000110000100010011101111000000000000100010000000011101010000110010000000000101000000011100000
00000001010010010000111100010101011010010111100111000000000100000011001000000100001001100000100000001
01010000000010101100001100001000000000110111000001010010101010110011000000000010101000010100001000000
10000100100101001001010000010001000010110110100000000001010110000010101100001001000000100001110001000
00010000000000001000100000100011001010000101001111011000100101010000010100100010000100000101101101010
00000011000001000000010000011100101001000000101011011000001001001001001010010101001001000000100000000
11010110000010101000000001000010101000001001010001010110010000110100101000101110000000001010011000100
10010110010001000000011010010111000000110010001010000000101110000000011010110000111011101000100101000
10101010111001101001000010101101010101000100000100000000010010010100000000100000010000000010010110100
01000010100101110000010100110111110000000000101010010010001010010000000100010011100000010000000001001
10101010000000001011000101001001000000000100011010110100000010100110000111010010100000001000011000101
11100001111001011010111000010010000010000100000000000010000001000000001101011010001000000010001000100
01001001111010000010000010011000101100000001101001110100000100000100000010101010000010100011010100000
00000010000001001011000100000000000010000011000001001110100001001001101100101010000101011100000110000
01111100110000000000000000100100010110001000010110001000000000001010000101010011000100100000001111000
00011000100101000001000001010010010100001000001010010111000100000101101000101000000011001100000000000
00110100001111000010110000000011100011000100010101000010011000000100000100011100000100110000100100010
00110000011011100111010000011000001011000000010000000001001010101000010101001100000000010000110110111
00100001010100010100001100000110000000110000010000010010001000101000001000001000110000100100001000000
00101000011000000010001110000000000000011001010110101001001001010010000000100100000101000110001000000
00100010010000010100010010000001011000100000001011010110011100011110000000100000110110100001100001001
010100000011000000001110101G0000101000011110001000111100100011000110100100000010000010000110010000000
01100110001000000000000100000111010001000010000100101111010100101101000001101000000100101001100000000
01000100011000110000000110001110000011110000100011001001001000000001100011001011010000000101000000100
00001000010100000111001001001011011100111001100101111111101010101000001000011010100010000000001010000
00000000110100000110010000100110101000100100000010000100000000000100000000000000000011011010101001100
00001100001000000001001100010000000110000000000010011001001011000000100000101000000000000001100010000
01110000001010001100100010001001010000011001001110001000001101001001001000101010000100001100110000010
00010100100000011000011000000000001010000000001000100111100010101000000100000010101000000101000000110
00000010100101001100000111101000000011100000000000000010001011000000000001010000001000100010100011000
00000100101110101000000000010001011100100100010001010010001000100001001000100000000000110110000000000
00110011110110110000100000000000110001100001010001101000111000011010000001001111100100100010001000000
00000010111100000011010001100001011000010101000100000001010100100010000100000101001110001101010000010
00000010000101101101000001011000101001101001010001010000000000011010000000010011011000000001001001010
