00100000000011000001000110011001001001000010000101000100100001011100100001000000100000100100011000010
00000100101000100100100100001100000000000000010111110111000001100000011101010001100100001000000001010
01001101000100001011011010000000100000000001000100011001000101010010000010110000000111000100010001101
00011100000000100100000000010000010001000010001010000101000000100100001010000110000001000011000001101
00010000101100000000101101000111010000000001100100011001000001010000110000100000100000010000100010000
01000000100010010010000101001000001110100010000100000000000000000100101001001000100011010010000011001
10010010100011000101000100000110010100000100100001000000010110100110000001000000011100100001100000101
11000001101010010000100000111110001000000001010010001010100000101001000011000100101001100010000100111
00010011111010010000110101000110010000000100101000110100110111000010000000000001100100100001101010101
00101100010000000000010000000000101010101010000000000110100110110100101000101000100100001000000000010
00010001100001000010000101001001101110011000101001000100101010000001001000010000000000100010011111011
00010100101100011101001001101000010000000011001100100011011100010000100000100110000000100000100010100
11100100000000100000010000100000000001101011000000010101010001000000000000010111110000011001001000111
00010000010100001011111110001011000010101000010000000100000000000000011001000010101000001000010000001
01000101100101010110100001110001000000100011101000000010011100001010011000100101000100011001000000000
10000100010101010000000100000000000101000000000000110111100001000011101000000000000110000000010000000
00000000001010110001001111010101000110011010001000110100010000000000000001010100100001000011000100001
01010010100010110000101110100100010001011001001000111110000000000001100110100100001000000101101000111
00000100001010010000100000000000000011010011000000010000000000000010001110001110000001011100101001110
01000110011001001101000001100101000010000001111000000000101001111100011000000010100001000001101101001
01010010010000011100001010000010001010101100000010100000100000010100100101001010101000011010010000101
00001011101110011001010000100100000100000000000100001001101000000110101001000000001010000100111000000
00100100100100000100000100110000010000000010100000100010001010001001010100000100000000010001100001011
10100100010000101100100000001110101001000000001100111011000101000000010010010110010000000011000001010
10100001101001000111001010111100000110101001001000010001111000000100101110010111110001000111001111001
01001010000011011010001000000000010000001100010100100001000101100010100011110000000100000000001000010
10010001100001000001110000110000100100101001010000010100001010001100000001100010100000001001101001011
10010000001111000001000011011000000001100000010000000100000110000010100001000000010010100101001001010
00011000000100111000010000110001011110000111111010001001111101010110011000101110001000000000000000001
10001100000100001100010001001100100001000000010110000001100111010001000010000101000100010001101111000
01100010010000111000010010000000000100010110000001010010001001000110010001101001000000101010000000100
10010101100000100100000100001100100100100101000111000001111000001110101010101000000110100000000001100
00110100010000111001010011001011011000000000001100010010001010110001000100001100101000000000001101001
01111000000101001001000100010010110010000010011001110000000101000010111001110000100000001000100000100
11000001000100000000001111001000001001000100000000010001111001000010100100000000001100010010001001010
00001010000011110001000000000100010011000101010000011011100010010100001000100110000000000000100000001
00000001101011100001001000011000100010000000101000111000011010011000010001110000010000110101000010000
00001000000010001001110000100110101010101100000001100100110001000000001000000010000001111000000000100
00110100001000010110111101000001010011100010000101001111000000001110000000110001010000100100010000010
00000100101010100000101000110101000101100000011010010000000000000100000001000100010000001000001010001
00011011000100000001001000001011010001000001010100100001001001100100001000000101001001110010000000100
00000010010110001000000000000001000001110000101011100110110111101000000011001000010100100100000011100
01000001000001000000000011111010000001000001100010100100011000001100010100001000010000111000000000000
00001100001000010001100000111100000000000000110010010000111010000011001000000010101110000000011011001
11100000100000100000000010000000000000001000000001000100010010101001010000000010010000000100010000000
01010000100001001101000000010000001000001000000001001100000101101000001011111001001101001000000100000
11010101010101010000001000001000001000001100000001011000110111010100101010000100010001001100010100000
00010000001000001000001000101101000011010010100110111000101101000000010010011001000010001010000101101
01100100000000001000000100010000001101001100110000000001110010010100000100100001100000010110000001000
11010010101000000011000001000001000000000001000100000100100000010000001001110000110001010000110110000
00000010100101000000011110010000000010010100000000010011110010010000101000100101000000000101000000000
11011010000001000101000000001000S10000000101000100000101010001010000110010000100100000001010011010100
10011011010110011100010000010001000000101011011000000001001011100111100001000001010101101000100001001
01000000110000000011000001010000000010000010100000010000000000010000000001000110001000110001110110001
00110000000001101101001000001011110001101000010000010000010011101000101001011000011011111001000101001
00011000100110100000000000110110000100100101000100010010001010111000000010100000110010010100010000000
11010100011100001000000110000001001100010011000001011001100010001000100010000101010111010010000000100
01001010000111000001111010000010111010001000000000000000000000010000000000000000010001001000000000010
10011101000100000101000000001001001000100100110000010111001000000101100000110010001110000000000010011
10110000001000010000000000100101001010001000001011000000000010000100100000000000000001111010101100011
00010000101000001000010101010100010000100110000010100110111110011011010100000101100010010000010010011
10100111000100100001101000010011001101000010000111010100001010001010000000000000000000100100001010101
00010001010100000100000100010101001000010001000000011111010000000100110000000000000100010101101010000
01000000101000010000101100100000001000000000000001011000000101001100100100101101000101001101000010001
00000100010100000000011000000000000001100001001010000000000110000000000001000101101100101100101001011
10010111000010000000000010010100110110000011000100101000100100000100000101010000111100001010000010001
10100000000111010000011100010010100000110100110000000100100000101110000100010000000010001010010100000
00000100010001000001000010000010001011000000000000101000011000000100000110100000110001100001000001001
01000010000000101010000000010010001110000001100100101001100111010101000000001000000010010000010101100
00100010010101000110101010000011001000100000010101100010001101100100000000100111111011010000000010001
01110010010010101011000100000000011101000010100000010000000000010000100011000000110110001000101000000
10000000010001011001010100101000000001000001000000001100000000000100000011001010000000000010100100000
0100110000001001011010100000100000000000100110100001000G100000000010110000100000010001000000100001001
00000000000111010000000011010010001000100110001010010101000100110100001011000011100101001110100000010
01001001000000000101000000000110000000010000000011110000100001100001000000010100000110100001100001110
01110010101100110000000111100001000000100100101001100101000110110000000000110100010000000010000111000
00100100100001001010100000100101100100000011101001101000100000000001010010010011000010010000000010100
00000100100000100010010001000001011000111000000110101110100010100000000000001000001010000000001110110
00000001110111000100001000100011110000100001100100100001101010011100000100010111011000000010000000010
00010000001000010000110100001000000010101001000101000100011001000000110000000000001101101001110110001
10001000000000100100011010111010000111001111101110011001000000001100000010100001001000000010000000100
00000100001011110100100001001000101000100000001011010010000110001010000010101101001000000010100110000
01111000100100010000100001001000001000000000010101000001001000001010011010001011000000110000010000000
00010010000110000000011110010000011000000000111100000000000101100000001000001001110010101111101000000
00001000011110010101000001100111000101010000001010100010000010110001100000000100010000000100001110000
00110000101100100100000001000000110010011001100100100100010000001000000010011000000100001000100111101
10001011000000001000000101000011000010001000001000011000000010010000000000110011100000101001001110000
10010000001000011010000000010010000101000100000100101011101000001001010001100000001101000111000000010
11011011001000100010100100100000010000001000000100010000010111100100100101000000010001010000110000110
00001011110010010010000100011010100000100010001001111010100001000000110110000111000001001010100000011
10001000110110000000100001101100100010011001010000000100001100101100000000000110000100101100101100010
01100110010101101000100010000010110110110101001100000110000000100000100001011001000100000110110010100
00000000000000000111010101010000000111100100001000000010010110000101000100011000100100000001001010010
00101000001001100000000100110010000001010001010000000101000011010010001010100010111000000100110100000
00001000001100000010110000110000000011000000111010000000000110001010101000010000000110000010101001110
00000100000000000000000010110000101100010000010000000001000010001010110001101000101011000100001000001
00000110000110000000010100101001000010010110010111010010000001000101001100010001000000000010000001001
01010101001100000001001100010000110000000000000010001001110101000000110010101111000111010000010000000
00010010000001100101111111001110011111000001001001011001000100000011000000110000011001000010000010101
01010101000000100111110000011011000001000100000100110000001010000000010000001001010110111110001101000
00100100001110000011101111101001000010001110000000001010110100011000000010000110001001100010000110100
