11001001010101111000000100001100110011001001101000100011000111100101100110101000100001000010010000010
00010010101000110011011110011000011010010100001001010100001110011110010110000000010011001000011000110
00010000011011000000000011110001000000100010001010000111000010000010001000010100110110001000010000001
00100000000100010110101010010100011000010110010110101001001011001000011011000100001000100010100011010
10000001111011101100010000010100000000000000011100011000001000100100010100000101000101000000100010001
10111000000000100110001100101001000101100000001010000000001000000000011110000000000001100101010001010
00000000100001000000001100110100001011000111000010100110101110100101100010000010101011000010001000001
10010000000101101101010001010001001111010000110101000001010001111000000101010101101001001101010111011
00000000001000101101101000100000010100000010000100000010101101001100000011110010011110001000010100011
00000100010000000001110000010000001001100111000000011000000000000110000000110001010001000000101000001
11000010111100011010101010001001000100010001000110111110100001100100000111010000000000000010010010110
11001010001011010000001110001110010000101100111011010110000110001110000000000011001011100100100010000
10101000000010110001000100001011010000100110100100110010000101010001000100000111010000001001100110000
11011010000001010000001101111000100000000000101000011111000010110001000010100110000000001000100010010
01010010110000000100000101110111001010100001010000001001110010001011000001001011011000100101100000011
01110000110000000101000100010011001001101010001101110000000110101000111001010000000000010000010100001
00000001001000000100010001101000010001100011010000001100000000100100111100000100010000100110000001000
000100000000000000011000010101100000001010100011110110000011S0000000100010011000000000100100011000000
01000011011000010001001001110000000000000000000000001010000010000011000000000000110010000010100010110
01000010100101000001000000100010000001000101010000010010110000000011101010000001000010101000100000000
11011101100000001000100010100001100000000010000000100011001001010100000010101000011000000101000100000
10000000000011001111110100001100001100000101000101101111101010000000010110000011001000000000101000101
00110100100101011000001001000100010000000000001001101101010100010000000000011001000100100010011001001
00010000010001010111100000000010110000100000000100010000011100000011000000010100011010000110010100111
11000101001100000100000000000001100001110000000000010000010001100000000000000000001000100010110000100
01000000100000001001000000000010100000100110110011000001000010000000000010001100101000001000111000000
00101100100110000000010011000100101110000100000001000010000110010001100010111011011010101000110001100
11100000100001000111000000000000000000100110001000001101001100000110001101000100010100010100001010000
01001000000110100000001000011110010000001000000011010000001000000000100101000010000000000000101101100
00101000000000010001001010000000111100000001000100010001000000110010001110000000101100010100111010000
00101000000000010000001101100100111101101010110001100000100100000101101100000010110110001100000000100
10000000001000000000110010001000100001001011001110101001100001000010001101001100110011110000100001111
01100000111001001101101100001001000011000000000000010000010000111010000000001010100010110110101001000
00001000000100100010000000101001000010011010001100110000101000010110000100000010101100010000000100100
10001010011010000111000100000000000000010000000110000100101101101001001000110000001010000010001010100
01000000000000110101100010001011000000010010000010000000100000010000000000011000000110110001001001100
00000100001000000100010000010010100000101000001000010000110010100000000000010101010010111100011110000
01100001000001001001011101001101000110101001111000011110000001101011101001001001000000001000010010010
11000111000100000000000001011100000110100000011000000000100000100000010010000000100001111000000001101
00010001001000001100000100011101100000110001000011000001100010011000010010100000000000100000000001001
01000011010000111101000001010100010101000000010001101111000010100110000010001010000000010000100001000
00110001011011000000110011001001011000010100100101101101000000001000000010000001110100000101100011000
01100000000000011000110000100000000111010000001110110100101001000011001000010000110010110001010110100
11011001000000101000000010000001000000010000101000101011000100000000000000010001000011100000111000111
11100010011010000110101100010010010010101000011001001010000101000101100000000100010001111110001010000
01000100101100101101000000111101011011001100000101000000001001101011001001100100110000110100010110010
00000010010000000000100000000001000110010000111100000000100000100000000000000000000000000000000010001
00110110000010001100010100101001000000000000100000100010001000001000100000010011001100111001011001000
00100000000000000100100101000011110110011001000010010000010001001000000001111010001100010100000000000
10000100110001101001110110000001000000010100101000100010100000111011000000011001001010100100110100101
01101000000001100101010000000110000110011010001001000000001111000000100010100010010010000101010010100
00010110001000000000000010000001000100000001010000001100000100001010011000100001100101000010001100101
00110010100001010000010000000000010000001000011000000010000011010110100010000010000100100011000000010
10101101101010010000001101001110000100111001010000101000001011001100011011010000010001010000000001101
00000001000000010001011001000001001010010001010111000011100001000000101000100000001011000011000100101
01100100010010000100100001000010100001100100100101010010011101000010110000000001100100011110001011010
10001001001110000000111000100001000000100100100000100100000000011000000000000011101111000110111000001
01101001011100000010000101100011001101001000100100010000000001001000001110000010000100000000010000101
000011000100000001001101000100011110000000101010000001001101000101100110100000001G0011101011000101000
00001101010100000010100000100011010100110101101011000110001001000010100100000111000100000100001001001
00001000001000000001001010000000010000000010101001000000000000010000111100100100000100110000111000000
11000001000000010000010001010000100000100000000101101000000100000010101011000001001010010100000000000
10000001000100000101000011001001110110011110010001000100000000101000000100000000110010001010000100101
01100111000000011010000101110000000101100000010100011011000110101000110000101101101001110100000100000
11000010100010000000010001111000001010010000001010101001010111111000000010011000100110000101000100000
00000000100010000010100010100001001000110101001001000101010010111011000000101101010100001011000010000
00001101001000000100100000110001000011000010101100001100000010100000011111011101000000000000110100101
11000110110111101010011001110001000001000001000000011100010011000110110010100100000000111010110100000
10000111011100011000110000010100001100000001111000000011100001101000000000001100000000110011000000010
10010000011010010101110000001000000010010000000000111000000001000100110011010000000010010000100000011
11010000010000000010000000100000000010010000010000101000000001010100011000000000111000110011111101010
00001001001000000000011000101100000100000110001011001000000110000001000011100000000101010000000110000
11100010000000010101001010000101110010001110000110010000010000011010101100100100101100000100001010010
00001000001101010000000001000000001001001010010100011111010010100010000011000000011000010000010100000
00001100110001001000000110000011000000000110000001000111100001100100100001000010001100111010000001010
00110100000001011100000100000010000001000000000111010110101100110010000010001000000001000100000001101
00001100000001101010100010000010001001111100010010010010001111011111000100000000101001000001000010000
01001010001000000110001011110000000000000001010011000001000100010100101011101001000111010110000000110
00010100011001000000001110100110001000000010100011010000001101000001110110100000110100010110011001010
01010010000010001000100100010010000001000001000000010000001001001000000000001000001001010100100101101
10100000000000011101011101001010010000100100010000000000000001100100110010011111101010000001110000001
01000010110000000000000101000000101010110110000000000000011101011110000100101000100001000001000010001
00010000010000000100000000000100010110000001000010000110001010100000100110001001010000001110100000111
01000010010110011001000101000000010101010110001010001000001100001011010000000100001000000010101000101
10000011010100010000000011000001010000110101000001000100011111110101010000000101101000101111010100000
01000101010001000100110001100001001010000000110000000011001010001000001000000100010000011001000010001
00111000010100100000000110100100000110001000000000000000010110001000000100100101000000000100000000000
01111000000000000111000110100100001011001101100010111100010010001000100010101000000110100010000011011
01010000010000100000010001010000001000011000101000000001100000100100010001000000001000010100000101001
00000000010001100011000000010010001010000101000000110001000000100001010110111110011010000101000101110
10100000011110010110001000100111011011000000001000110000010000000000000010000100100100010100010000100
10001000000011110010001100001001010000010110010000100000001010110000000001000001110011111010111100011
00110101000000010001111100010000001100000000101000000000000000101011000111100010001000100001010100000
10000000000001010001010110100000100000100000100100000001010000010100100100000100100000000000000010010
00001010001011100011100010000000100001000000000101010000110001000010100010001100001010001000000010111
00100000000010011100000011100000001000000100100001000000101001000000100000010101000100001001001100101
00000010011001000000010100000000010000001010001001000000011101000011001100000101000000000010001100000
00110101101000001101011001101000100011110010101011100000100001010111000011010010000000011001010000000
00101000000001001100101100101000001000001010101000000000000001000010000011001010000100010000100000100
10000010011111101111110001001000101000110000000101001101001111110100101100101000100010000000000110000
01100001000100010000000000000111001100110011100101011111010000010011000100000001000000010011000100001
