00111010000000100100000010000011000000011100000010110000001000000000101010000100010101001100110000101
00011100111001110111001000000100100001000000010001000001010101110000001010010100101000011100100001111
00011100001110000000100000000101000000110100000110011001100101110000000000100000100000110000100001010
00000100110101000001001000011010000000001100010100010000010000001000001100010010110100000000010010100
01001001010111001010010010000011011000001010001000000000111011110001100000000000000011010101001000000
01111000101100001100000101010001101001000001100110011011100001000000100000000010100010000110000100010
01110000010000100000101100110011011100000011001110010000000000000010001100000100100000000010110000000
01100000011100011100010000011010100000000010100001010100000100000000110010100010100000010101001000000
10001000010000000000100101001000000101011000010011011100000000000001100001110010010000000101000101001
01000000000110110001000101000000011001000100000110001000000100100011001100110100101000001001100100000
10010000010110100001000001100000001010111000011010111000000011000100000010111011010000010000011000000
01000110000000010000100010010000001000000010000000011001000110110101001111001000001000000100001100000
01110001101000100010000100110010010001100011000000000100100010000000011000000101001011000110000110000
00000000110010101100100100001010011101100100100001010010111000000110000100010001011000100011000000000
00000001100000110011010000011000101101010100011001111010011000100100001001100000000001110101000000000
00001001111000010010010000000000010110000010000101100001010111100000000001000000101010000111001010011
11010000100000101011110001001010000001001000001000100000001100011000000101100000101010000100001110010
00001000000001101001000110000110100001001000100110100001100010000000000100011010100010100100000001100
10010100100100011010100001001010010000010010000000000000100000110110000010100010000010000100100000000
00000110000011000001000101000000010000000000100101001011000001100010010000101000100100010000110101001
11010001000010010000010000000001010101000110000001001011000000010000000010010101001000010101000000001
01000000001001000000000001000000010000010000110010101001000000100000101010000101010010001001001011010
11001000001010010010100110001001100100001111100111010100010011000101000100100000010000100000100000010
00000110001101000101001010100000010000000110000000000101100011010010000011000001011110000010000010000
00011010110000000100110000100101000100000000000000100001001010010000101100101000000101101010100000100
10010101110001001100010000001000000000100001110000010100000110001001000110000000000010100010101011011
10011010000001000110010100001000000001000011001000010110011001100001000000100011000010000101000100100
01000010010110111101010001100110000100100000101011011001100101010010000000000100001000000100000011010
10011000000011100001001001000000000110000101010010110100011011100011010000100001000110001000000011100
11101000110010000000100011101001010010010000100000000000010100110110010000000101110101011001100101000
11100000000000101100101000101010100101100011000001010000001100100111100100000000010000000110001010010
10010001000101010000100010000000000100100000010000000000110010110000100000010000010101000100100000110
10000111100001001000110110100000000100010100000001101011000011100001111000001000100100010000111101011
00100100101000001101001000000001000101101100000100100000100011110010011000000000110001100100000000110
10000100010100000010100010101001000101010000000000000100001011110100100000001011100100100000000100010
10000110011000010001000000011001100000100001000110000000000010000010010000000100000000100100000000000
01000100101000000100000111110000001001001101011101000001010110111101001000000010010000001000000001000
00000100100110000100011010101000100000000000110000011011100100101000110011000000000010100100000001000
10001000000001101100100001100000011001100010000100010010111000010000000010011101011000011011000010011
00000001111110000101010000110000110100100001000100001000001111000100101001010000110101001101110101100
00000100000101001010100011011000000010000011000001000110001010100011000010100000100111001101000010110
01011011010000011010110000000000100101100111011001010001010000100000101000000000010000100101000010011
00000010001100000010110000100010010001000111000100000100001110110010000001100011101000110000000100000
01111000001010000010010000000000000000000000000000010001000100100011001000001000000000100000000000000
00000000000010111010010111000100010100100010001101000000001000010111100001000010110100101011001001000
01000000000110010000000000011001010011011001011000010000000000110100010010011000000100110010000001100
11000000100000001101101000010010010100100011011001100000010000010110001000001000101100000000110001001
00100100010100011000010000000000010101000000100001000000011000100010001000111010001010000100000000100
11110000000100101000000100100000100001101010111000100010100000000001000110101000000000000100000101010
10010001000010000100110100110100101010000010101101000000000011010100000000000100001010100010010100100
10000101100001110010010101000000010101100010100100000000010010001101001000000000100000101100101010011
10000001001001000000000101010100001000000000000000101101000011000111100010001010111010100000110000100
01100001000110001000110100011000010000001000000000000000001000111100111000100001000001100000011111110
00001100101010110010010000001010000000000101101000100010100001100000000001010010001100011001000110100
00010010000111000000000110101010000101111000000010100101000010000000100000001101010001001100010001011
11010010100110001000100100010010010110000100100010001010010000000010100000101000100010010101011100101
10000010001101101011100100001110111000000001010000011100010101011101000100101110010001010000010000001
10100000000001100000000100001000101101011000010000000011101100100100001001000011011001000011100111010
11011010000001110100100110100000111000101010000000100001001000100001001010100010000000001010000000010
11000001010110010001011000001110000100000100100000100000010100000010000010000110000000001000011000010
01100000110000010010101001100000101000010101010111000100011010100011001000100100000001110100100000001
10011100000100101001000100000010001100100010101010000100100000010100011100111000000100001110100000100
00011001100010001010000000010010000000100111100000010000000100001110010001000101011110000110011100101
01010000001010011011000100100100010100010000001000010011010001000001000011101101110000000000100000011
01001011101100101011100000010000001010000110001001100011001100100100010010000110011101001100100100011
00001000001010110001000010001100000001001100000001010001000010001100001001001000010110110001001100010
11000000011000001000101100110001010100010010001001100110000100000000000000000000001100000101101010001
00001010100011011011001000010001000001111000000000001000100001100011100001101010100010111010001011001
00101111110010110101111100000110000001100000000000101000000110011000001110100100100000100000000100000
10100011100000010101100000000011110100010100001000010010000010000100000011010100000111011000011100100
00011000010010010000000000000000000001011000001010000100001000100010001011000010100000010000011001011
01000101010011000001000010000000001110101001000001110111001100001001100001110011000011100111000000010
00000000000000100100000000000100010000000001010010101110001000101000101000001100100000001000010001000
11001100000000001000101000001010000011100110100010000101000010000010111001001110000000000010100100100
00100011001000001000110100101100000001001010010101100000000000001001001010100110010011100010001010001
11000000000000100011000011000000111011000010001000100010001000000100000000000000111111011000011000000
01001001001001100001000000110000111000000001110000010100001100100100010000000100111000100000101110001
10010000100000001000000010010100001000000001000001100100100100000010110010000011001110111101000000001
00111100010110010001100000000001000011000010001111000000010001001000000010010000010001000011100011000
10100000001000000010001010010000000100110011000100001100010101100011111000010111100100110000001000100
00010001100000011001010010010000101100100000000000010110110000000100000100000000110000000110100010100
00100000101001001010010000100100101000011000010100111001000001010000000000000101000000010000111000010
10000001110001001000110000010100000010110001011010101000000000010000100010001101110110000000000000000
1111100001011001100001000101000100000100011010000100000000100001000S010010000001001000000000000000000
00000110000010100010010100001001000001000000100000010000011000000001000000000010001000000100000001010
00010000000001000000000000100000000000100000010000011100000001110010010000010000000000000000010001000
0110000001001000000010000001000100000G000001001000100000010101000010000000001101010001001110000000011
00000101101100000010000000111001010110001101000000100011100110100010101000001101111101000000111010010
01010010010000110010010111001000101011101000000000000100100110001000010000000100001000000110110110000
00000100101010001000101000010001100101100011000101000000000100000000000000000101011100000100100000110
00111000010110000100001100100011000011000101001001000001111101001101000100000101010001010001010100000
00000000001000000010010000001001110010000100000110000110000000100101000001001101000101100000101101110
01100001101010100100001000010100000101000010001011010100010101111110010010000001001100000100010100010
10010111110101010000010111000001110011000101110001000001010010000100001000001010010101100100101001010
10001001011000001000001000011010010000000010010001110100010000101000010000010010000000110000100101100
00111010000110001000000011011000100001010100011101010001001010100001010000010001001100000000100100010
00000010000000000000000001000000011101001010101101000101010100011000001111100000000010100000100000000
00100000010111000100001000100101000001101100110001010000100010110100100000010000101000010000000111110
00000010000010100000000001001100111101000000001101000000010010101000111000000001101011011010001001000
00010010010010000000101100100010011010110000010000001001010000001000100100000010011011001000001100100
10011110010000000000000000100011001111010010100000001010000010100001110000011000000000010010001000011
