11100110000000000001010001100100110000010010000001001001100001011110001100010000111100100100001010000
00000001101101111000000110100001010000001010000001001011010001111000101101110000000110101011000001010
01011101101010000000010011000000000000011000000000011000000100110110100100000000110100001000000111000
11000000010111001000000000001010010000010110100010001000111000000010001000001101000000101001000000100
11000000001110010110000100110100001101000000110000000111101101010000001100010000110101001100010001100
00100001011001001101001100010111010011110010111101010101101010000100100010000000010010011000011001000
01000000001111000000000010110000001010101101011001000001000010000100100101101000000100000000010000010
00100100000000001100100000001000010111011010110000000010001001011110101101001100111000011000010000011
10000100010101000100100100000010100000000000100001111010000010011111100101000000010100010000000001000
10010001000100000000010000000011011011001111100000010000000001000010001000000010000000010100000010000
11000111011100000100010100000000100110000000101100010010000100100100110100000000000000010101100000000
11000000001001000001000100001101001100011001010010100010011000000000000000100011100010011000000000110
00111010110000000000000000000100000000000101000100100100000010001010000011001000001100110000100100100
11000010100010000100011110000010000001101100100010011000111000110000111010101010001001010000010000001
00001000010000011011000000000100100101110010100111010001000010010000100010001000000101100000000100100
10010010100100010100111100000011100001001110110000000000000000000000011100001101000100000011001110000
01101100011010000000010001001000010011010000001000000100100001010000010001111011000000000000100000100
10100111000000001001000001000101110001000101011010010100100000001010010010000101000000000000110000010
01010010101010000000100000000000110010010101101000101100011000000000000000011100000100001010000100100
00001001000010010001000000000000000000000101010100000000111000001100001000100000010110000000100110011
00000000000010000000010010000010001110011110100100000001001101100010000001001111000000000100011101111
00000100010000010010100000011010000000010000000000000100100101110000100110000000001010110000110010110
00001001001100001000101000010001100001000000000001001000011000000010010100010001000100000000110001010
01000110010100000110001100000000001011000100101110010000110000100110101100000100010001100000101101101
00010001000000101100100000000000110100010011100100010100001010000100000000000111000100000000001001011
00000101001010010001100001100000001110010001110010000100101001000000011101000001010100001000001000001
00010011101010000110010000000000000101000000100100100101000000000100001100101100010000001000010100001
10010000000000000000000011000001010010110010001100011000001000000000000000100001000001010100000100010
11000000000010101110110000100001000001001001110000100111011000000011001000000110001011001100000000110
00010000001000000011100000001000000001100101100000010001000000000100001100000000010001000101000001001
00000011000110100010000010000000000000101010100000000100111001000000000100000100000010000001000000000
10000100010100000110001000100111000000000100010001100001111100001011000010110010100010000000011010110
101001G0000110110101100110011011100000101000000101000001000001010000001000000100000101010000110001001
01100001010010000001010000100000100100000110010100010011100100000001100100010101110100110101000011001
01001000000110001000111100010011100100001100001000000000100001100001000000000010001101100000100100100
10001010011010101100011101100010000000000000010000000100000000100010010000000000001001000010000101000
01000100100000001000001100000000000101001111100100001010011100011111000101001011000010010000100011100
01010000001000000100001111010000100100100010000000010010001000001100000000000000000011000100000101000
00010011111001001101000001000110100000010000100000000000000010010110011001011100000001101001100001000
01000100001100100100100001111000100000110110100011000001000100011010001100000000000010010010000100100
11000000011010010100111010001000011000100100000100010000010001010011100010100000000100001010100000000
01010000010000100100000100000110000110000000000001001100000011010000000010000001000000100001011100001
10110001110110000101001000100001100000101010010001100000000000100101000000000100100001000100011001110
10000000010001000001100000010001010100100000101010001100000100000001010100001001001011000010010000011
00010000011010000100011010100010101101001000000001001110000001001000100000100110101000000000000101100
00001000100101001010100010101000111000111000111011101101100000110001101100011100000000101101000100011
11000000000000000001100000000110101000111001000000000001010001110010000001000011101100011010000101100
01100001000000000000111100001000101000101000000101001001100000010001110000010010000000111100010000000
10000000100000000001000000000010000101010000000000010011000001010101010000100001100100100000100100000
01000010100100000001100001001010100000101110000001010000000011010000010010000001010000000000001111001
01000100000001110000100111000001000100000110110000010000100000000000000111110010000100001000000010100
00000010011010100010100100000100100001000010001100100000000000101000100001000000010000100000011111000
00001001100101000000101000000000000000011001111010100111100000010101000001111100111100010000110000100
10100000110110001100101000000101100000000000001000000000101001010101000010010000000010000000001000001
00100010100000000111001001001110010000101101010100010000101110100100000001000010011000001000000000011
01100110011000011000010111100001010010001101010010001000000011011111000000111101000000000100000000100
01110000100001100001010011100010100010101100000011110010110001000000100000001111100010000000100100100
00010100001100111010111001000111100000000000010100001010001000000100001000001000011100101001001000000
01010001010000000000100100100101111001101011100011110000000100000000001101010010010000100001100000100
00101000000000001001100011110000000001110000100001100100010000000011001001010100001000000100011000000
00001110101000000010010100000011110000101000010100000100100001100000111000101100100000000100000110011
01011001000010110010000000100100001100010100001001010111000110010000001001000010000100010100100011110
00001001110001011011011010101010000001000000011101110001101101001010101000000010000000000010001000110
00010000100001010001000000001001110101111000000000101100110111000000000010000010000100000010100010001
00000000000010000000111010000000101010100110101001001011000111000000011110000010000110000000000111100
00100000100000111000001000000100000100001000101000010011000100101110101000111001110101000100001000000
00101000110100000111000011001101010000101010100101001011011100100100000000000110111010101000001001000
11111010010000100000000000000000100000000000000000011000001000000000100100000000001000000000010100000
00000000110000000010100100011101110001101000000111010000000110000010011000000010011101000010100000100
10101110010101100001001010000010010110000100000101110011000010010010110000000000100010001000010110000
00110010001000100000010110101010010100100111000000010100110000001000000000100000001100000010001000011
01100000100000100010010100110110110000100000101000000100000000000000110000010000100001100010000011000
10100001100000010101000000101000010100110000000000100000100001000010100000000000000101101110001010000
11100100110010000101001001010000010000000010000010100001001101001001000101001101100001010100100000110
00000100001010000000000011000100000000011000100000001000000000010000000010010000000000110011000010000
00000001011000000000000001001000011100101000001000000001100000001110001111001100111100010000011010011
00100010000010010100000110110101100000010100110000110000100010100000000001000000011100011100011000001
00110011101011000100001000101101000000010111000010000100011110000000100000000000101001000010000000000
00000001010010011010000001000110000101000101001010000010101010000011000000000000101000100001011000100
01101100110000111010010000100001000100000010000101100010100101011100000010001001000010000101001100000
00000110000010010000001000000100110101000001010010001110000000000000000010111100010000000100010101101
00100010100100000000010000000111010111101010101001000000000010001011100101111100010000000110010001111
00011100001111000010011000011000101000100011101010001010001000101100101000010000010101001100001000001
10100010100100010011001001100100010000001000000000110001000010000001100001001000000010000100010000000
00110001000000010000010001000001110111001000110100000000000100000100101001100001011100000011111011000
11111000000000110011010000101000010010100100000000000011101110100001010001100100100100100000000010000
01010000101000000101011100001000000001001000001100000001010000101010010010000000010010100001100000000
00000100100001001010100001100100110010100011010010100101000010001110000110000001000010110010001100010
00001100010011100001000001011100000110000000100011110010110001000000100101100100000100000110100000000
00100000000000000000011100011010001010010100000101110010000101000100010000000100111000011010110000000
00010001000000010110010100101100001100001000011000000001010000000011100001000000000001000011000000100
01100000001001001010111000011010011000100100010100001000010000000010000001000000000110010000000001001
01101101000100001000101001100011001101001011101001000100000100000000111000110110100100011011000001000
11011100011001000110100001001000000110100000001000000001000000001000001000000001100010000001000100000
01000001000000100001001001010010111101001000101111100100000000010001101100100000001101010100010100001
00011111110000001100000000110000001000000001110100111000100001010101000000001001110001000001111001101
10011001000010001001100100010010101010110000000010000010001000000001100111000110001101101010101000100
000010010001100010110000000010S0000000010001101000000000110011100101001110000110110100011000010111001
01001010100000101010000000000110000100010000000010100101010010000000000100000100011011001100011000010
00010010010101000000000011010011001000000010001011100101000010010011000000011010100000010000100010000
11010100010111000000001010000110001100010000000000000000000110000000001100100100100010100000010000011
