00000000001100000010100100000101111101000001011010000000101100010000100001000000000000010100010001100
10111010110000001001100010000101001011000001000001000000000000110100001000100110010010011001100100010
00110010111101010010000110000000001100010110001000011110010100001110001000000110001000010011000001000
10000001010000100100000001000000110100010000000001000000011000100010100100010100000100000100000001110
01001001000000001100011100100000010110000101001000101000001100000001000011010000000001001110000101010
11001000010011000010000100110000010000000001101100010100100100000111000100001000101000011011011000010
00100100110101010001010100010100001001010000000100100000100100000000100000100000000000010101110000100
01000000011000010011110100010010100100001000010011100111001000000000000001001000011001010000000000000
10001000000110000110000110010011010000000000011100000010110000010000000001000001111101000001000100000
01000001010001000000000000001001000001010101010010110011000001100000000010100101001000010010100001000
10000000101000000000001011000000000001110001001100000101001000100011000101000000100000110100000100001
00000100110000101100100001001000100000000011010100001001100000010000010101010101000000100000100100000
00001000000000001110011100110100001110001000000100101000000100110010010011001000100100000010100001011
10000000010101100000100000001000000101110000110001010000010001001000001100000101011110000010001100000
00000001000001010000010010000010001000000000001000000011000110010000010100011100110111100101100011010
01101000001011000100000100100010000011001110001000000000000100000101001011000101110000010001100000111
00010100000010000000000000100110100001111100101001000011000100110000111001101010010000100100000000000
00000000000000100000000000111000100010000001000000000010001000000000100010100000000101101101000010100
00010001010001000100001011011100110101101100010100100001100010100001001101101001000010000110001000000
00010000001010001000100111000001011100001111000100010011010000111010100000110000101000100000110001000
10011111001010100000100000010000000100010001001110010010011000000000111000110000110000011000000100010
01110011000001000111100000101101000000000010101010001000010001000001001000000000001010010100010011101
11010010001001010100000000010000110000010000000100111011101001001000010001000000001100100011010010011
11000000000001001010000001010000000110110011000100001001001100000110101010111101000111100001000010110
00000010000000001000100100001001010000000010100101100000000111100011100000010100010010100011100000001
11000100001100011110000000011001100000110000001001000110010000000011101101100100000110000000010010000
01001011010000010000001100100101100010001010010000010000000100100000101010001011100000110001100100000
00000001010010000001100010100000100000100000001010001011000010000001010010110011000000110011000000000
10001001100010000001010100100000001001100000100000001100000010000010001001100010100000000100000010001
01001000010000110001000101000100101100000000000010101000100000000010110101001111000001001000001001000
10000001100110011010000001000001100001110100110100000101100110100001010101101110001000001110010110000
10000001000000001000100101010100001010000110100101010000100000000010000101100001011100110000010110011
00010100110001101000010000001000001001001010001000011000010000100100000110101001100010110001101010010
00000101001010101000001010001100000000100000010001111000001100010100000010100100000111100100100010110
01111110001000101001000001000001000100101100010010001100000000000000001000000001000110100000000100001
00000100100011000001011000100010000100001001010010000000000010001000101010000000010000000110001111010
10101000010001100101010111000000000000100001010100000010000101100000001010100000110000110000000011001
000001G0000100000101111100000001000110001001000011000000011011001101100000001001010110001001011010100
10001100011110101100010000110101001010001100100101110000101011110101000000000001000000000100010100000
10100111101011100000100100100010010101000001000010010100110000001001110000100110010001010000000110011
01001000010010001110000001100011010001001101110110011001010001000000011101011100000100001000010111110
00101011000111000000010000000010101100000101010010001000011001110000001001000100110000110000100010000
00000001000011010000100000101000100000010000000100000001010101001101001101100000011000010100000011000
10110100010000111100100000000001100000010010100000100000010000010000100011010000101111000100101000110
10110000101110101110000000010100000100010011000000000101010001101101010100010001000010000101101100111
10000010110100000010000000000110010000000010010010000000000110100000000000101110000011010010000100010
10000010010001010011011010000010001000001111010000000000111001110000100100000101000001100101100110001
00001001011000001000100100011011000101000000001110001000110101000100111000001000001010000010110000011
00000000000000000101011001000001000000000110000010010010001000000110001000001001000000100001100000000
00010100000010010001000110010101000110101000000000001001011001101100001101010000000010101100100100100
00000000100010000011001000010000000110101011000000001000101011100000000010000101110101000000001000100
01010010100001011100000000000000101010110000011000000010011000001011000010110000110001000000000110000
01101000100010100000001110010000001000000001000110000000111100101100001110110100000010001111100100111
00110010000011010100100010001000011000011000100011101000010000000000100000010001010100001010000000000
01001001000001010011000101000011110000001001001011000000000010000100001101000001000000001110001010000
01001000100001010000000000000100001110100010000101000011000001001011000010000101100111100000010000010
00110000100110100000001000101110010000001001000110110000000000010000010000101110110010110011100011011
01001011000001000100001010011001110011000101000000011101010100000001100111100010000000001011101000000
00100010000001000010000010110000110001100000000000000000000001010010000010101000000000100010000001100
00000000001000110011101000000000100000000110010000001001101100100010001110101011011000000011000000000
00000000101000101000000000100011000000010110110100000101100000000001000000100000111110010000111100000
11010000000010000000100000000000111000100001100000000010000100000011011010000010101000000000100000001
10011001010100000011001001100010001011000000001100011110000000001000101110101110111000010001001000000
11000000001100000000000000000001101110100011010101001000101010001110010011100110110100010000000001000
10010100000000010000000000100001000010010001110010011000000010000001001100011100010100000100110101010
11111000000000010001100101000111000101000010010011100000100000001000000100000101000000011010001000001
00001001000000100000100010011000010101001001100100101110100001110110000100011001000000000100000010000
00001010000100001000000110100001000010000100001000001101000000000100011001011001111001010111001100010
00100000000001110001000001100000000010000110011000000100000101010100000110000010000010000100101110000
00001000000010000001000000001010000100000101001101100001010010001001100011011000000000010000101001000
00000100000001001000111000000100000011011000010010011101101000010110011110000010100000101101000101110
10000100000111000000111000000001000000110001000100000011111000010010100011000000010101111000001101100
00001000010100000000010101100010001100000000101100000100001101100010110110010000000001000100100100000
01011000010100100011100100000000000100010100000001000000010000000000100111010000011010011000100001011
10010001000010100011010101000000110000000000000000001100000000000001001001000001010001001100111011010
00000100011101001100100000001001000000010000100000000001000001011000100000000010000101000000010000010
00100001010000001100011001100000100100000000000101001000001101110100110000100000011110111001000100000
10000000111010010010101000100100100100000010001101100000100110001010010000001000100001010100101100100
00000010110011010000000000000000001010000000010000001001000000000000000000110010111001000000101010000
00000000001000100010000000000000000000000100000001110000000100101011101011000000000001101010000010001
10100100001000010000010000001101000011100001000010010010000000000001000001110100111000000010100101100
11110000000111100000001000010010000000000000001111000001000101001101010101110001000100110100000111000
00001000000000000000000100010000000100010101100000011000001000000001011001001000100000000001100010000
00000101000000101000001000000110100111000100100000111100101100000000010000100000010100000000010100101
10000001110000110010000000100000100101010000100000010000101000110000100000100001000000000000100000111
000001110001010010001000010101S1000000000101110010000001010000000010100110010001010000100001001000100
01000000000010000001011010110100011000111111000000000100001100000000011001000000011100100100100000000
10001011100011000010001000000000010000101010000111110010000000001000000110010100100100001100000000011
00000001010011000111010010010000010110011000010011100110100000101010001010101000000110000000010101100
11100000000001100000101101010011010001000100100110011010000110000100000000000101001000100000010000000
00100100100000000010000001000101000100000010110000100100000010100100011000101000111111011001000110010
00000100001100001101010100110000000000000100110100100000110010100101001000101010000001110001001011000
01011001011010010000000100010001000000101100000100000000001101101000000010000100001010000000100101011
01001000100110100000000000000100001111111110000000100000010000100000100001110100101100000011100001100
10001000001010000100100110000000010001101011010000000100010110101001101010011000000100000110000000010
10111000001010010101000011011010000001001100111001011000000001011100001001000001000011000000101101100
00011100000100111000000101100001000010000111000011001010000000010001010100001010001010100000000010100
01100000000000000010010001010010001100001000000000011000100000000001001101000010000010111101010000010
10011000111000001000100000000000000000000001110000011000000001010010101001110101001000001111001010110
00010011000100010001001001010001110001000100111000000110101010000100001000001110100011001011011000000
00001001101000001101101000000000010111001000110001000000100101100000100000001100000010000000111110001
