00000000100010110011001001000110101001001001001000000001000000000101100000000101001010110000000001000
00000000100010100100110001000101010010000100100000001000001000000010001010101011000010000010001010000
00000010000000011100100000000110100100010100100000000101011000010100110001101011111000100111001110000
10110000001001101000011000000000000010011000101000100011011010010000000000001000010010101101011010100
00001100010100000101000011100001011011000000100000001010000100010010000000011000010100101011010000010
00010111010000000000001010011101000100010000001000001010000000001001011001001001011100000000001100000
00000100010010110101110010110000000011011010000101010001001000100010001100000001000000000100010100000
00000000000100100000000101011100000010101000001000100100111010000000000001000001000100011110101000110
00011011000010010010001110110111001000000010010101000000100010010000100011000010011110000011010100000
10000111001100000010001000100100000000111010100011010100000110100010100100110100110000110010000101000
00000100100011101001101001100000000100010000101010001000101010000100000111000100011000010010000000000
01001000000100110000010010100111000000000100111001110100100000000010100000100100110100000101101000000
10001000000101100110001110110010000000100001010011110010100101001100101001010000001010110011010100000
00000101110110101001101000100111100000000011011100000000010010000001100011000100011001100000010101100
00000000001000100000001100000111010001100010000000101000000100011010001100000000000000010011000000111
00000001000010001010010010001111100000100000100001001110001010100010010111010000100010011010000000011
01000100000100110000010001010011010000101000100001110010001000001011000101011001100000000000101000010
00000001010001010000000111000110011001110000111001010010011011000010000011010010100010001100000000101
00010001011000001000110110000010000001000001100011111001101100011001001011101100000001100000110110110
01000110000010000001000010011000000100001100001000000110000101000000001000100100001001010001100011000
01001101100010001110000000110111000001110010000010111010010101000000000000101011000000100110001101000
10110011000010000000100010000001000101010000001101000110000111000010010001010010110100000111000010000
00100001011001111000011000000100001000110100110011001100100000000000001001000011100000110011100000010
00011000100100011000000001010000100001110110011000000011000000010001010000000001010000001001000000101
00001111100001110000010100001000110001100000001001011000000000100001110100111110100000000110100000001
11110011000000000000011011100011000011011101110000001010100011001001110000000001100100001000000011000
10100000110100111001101011011011010001000100101100100101001100010101110010100101000110000100000011000
00100110001001011011000010000001000010011000000101000110100101000000010001001101001001001000010100100
01000000110010100110101000000110100000000101001000100111001110011011000010000100000101000011101110000
00011010100000100000111010000010000000010111001100011000010000001010010001000100010111011010000001001
00001110100001000010000100000100000101010000000010000110100000000001001001001000000010010001000000100
11000100000001000101100010010010000010100001001001101011001101000000010001000100000101011010000010100
00011100000000101010001101010111010000110001100010110000001101000111101010000010000100001000100000101
01000000000000110110100000100000000000000111000100000001100111100000101000010001000001011100000000001
00000000000001000000000000110110001000000111001101001010010001000110000001001000000001000111000000010
00110000001010110011000110100001111100101101000011000001110010000011000001000000000100001000000010001
01000101010000011110000001110000001110011000010000000110010001100001000001010000100101110001100101000
01000101000110010101000100010000001000110010011100000010110000001001001000100101110011000001001001101
00010100001110100010001100001010100100110010110000000100001010010100000011000010010000001010010100111
01001000000001000000000100101010110111010010010100000110100000001000001000000010000100100000100101000
00000101001000000101000000010001000100010011001010000000001000000100011001100010011010000101001000101
11101100101000011011001000010000100000011101101011010110010000010000000001000000000000110001011001111
00001000100001110000010110001100001101000001110001001100001011000110000001010000001001010000010101111
00111001100000101100001111010010000001001010010110110000110000000010110011001101001010010010000100110
10100000010010000000001010000101110100000000000000000010000010011010000101000001010001000000100101011
01001000001010101100000101010001010000000000000000001010000010010111011000010010100000011000100000000
00000101011010111111001001000001000000010001001001010110000110101001011001000011100110100000011111110
00001000111000010000000000001010000000000000000010110000100000101000001000000000011101101000100000000
0011001010000001G001000100000011001100000101100001001011001000111010000111100001000100011100100000010
01001010000000010111000101011010100011000010101000000001011000001110000000000011001100010110010000000
00100011101100010110010000000000000100010010010001000000100010000001000011001011101000000010100011001
00000000000000000011010010000001011000001010001000100000010001000101100000001101000111001010000101000
00001100100000001011001010001010010100000001101101000000001011100100001101100101001001011111011010000
10000000010000100001001001100100100001000001100001110010011101000110101000010000000110010010100100000
00100000010000000010100001001101101100010101000110011000010000000110001010011000000100011000100100000
00001000000101000100100000000001000010000100110100000001010100000000110010101000100000011001000000000
00000001010000000101000100000100000000001100010010010001000001000000010101000000110001000101001110101
01000000001011000001011001010001010011000100000101100010001110011101110000100001000001010000000000010
00110000000001000001010000010110110010000100111110000000000000000000111110100010000000000000010001001
01010110000011111000000000001010000010000011000001100100000100000000010010011101000000101001000010001
00000000010100001000110000001011001011010001011011010100001010000001000101011000000100010011011000101
01010100010011010010000000000000011000001100000000000011100000011001001100000001111100000001011001001
00000001000100010000101100000010010100100000000101000000100000001000000010010011110100010101111100100
00000000010010100101011000001110000101101010001000001010011000110011000000000100101010100001100001000
01010000000010011011000000010011110100010000000010011000101011100000000010011000100001111000000110010
00000010011110000011000101010000000000100010110010101000110001000100000010000000010010101000010000100
10110010101110110000000010011001111010100100110001010110001000010000000010000000010001010100010011101
00111010010000001110000011011000100000000010001010011011000100011010000010010010010101111000001100000
10000110100101001000001011010100000100101100100011111101101001100111100001010000010110000010000000000
00110000100000000000001000100000010001010001001111101001100000000000110111000001000110010100000011000
11010000000101001100111110000000000000010000011100100011000001101111010010010100000110010000100101100
01000000000010000010110100000010101000001101000110101011000011001010010000010010100000011101110001000
00110001100000000000100100000000010000000001000000001001010010000100000111000000000110100001101000001
01100010000000010000000000111000101001000101000000000010000000010000000000000000101101101010100000010
00010010100000001101110100110010101000110010001010010000000001010010101001001000010010000000010010000
00000100010000011010000000000001100100010001000100000101000010001010101001100010111100100000000000000
00100100100000011000001000010001010000100100010000001000010111000011000010110000111011111101010001000
00000011001100010010011000000000100110000001001000110000101011100100100100110101010001001000001000001
00110001000100000000001000000000011001000010100001001000010000010101101011000100101000000110100000000
00100001000110000000101001000001000000000100110010011001001000011S11110010010000010010000011011001010
10101000010001011000001100100011110001000001001001000010101001001011010110010100001101000000001001000
01111010110000000001110000010011001000001010011001000100000000011100100010010010000000100100000000100
00010100110000110000011001100011000101000101000000101100000100100110100000100000001000000000000001000
10000000000001110011010000001110111000000011010000010101001010100001000000000001101000000010010111001
00001001000000011010000000110000110100001001000010000000100101100000000000000010011101001000110000101
00000010010000010100111011000001101010110000001111000011100010000100001000111000001100000010011000000
10010010010000000000101101110000011101100001000000000010000100001000100100000101001111101100110000010
00100011001010001100001001010000000001110000100000001010000100000011010111011001101010000000101100100
00001010000000010001000011000000100001000100011000101011110000101000001010010001000001010100000010011
10000000010100010010100000000110000010000000111011000000001000001111000110011000110010011000101000011
00010001011100110000101000000110000010100010110001000110000000010000011011010000100100100011000001010
11000001000001100110100000011000001000011001001000110011100101101000101010001001010100001000111010110
00101001010110101010000100010000000100101010001100001100000000100010000101101000100011000010100101110
00000000100100000000100000110000110001000101101010100010100000000010000010010000010000000000010001000
01000000010101010110010001011100001100100000001000000010100000000001011001001100100000100111000101010
00110010010110100000000010000010000001010011001101000100010010000001100000000010100000111011010000001
11010001001010010100100000001001111101000010010000000110000000010101101100000000010001000100010110100
00010000000010000010010011001000001001010000010001000000001000100000010100010111000100001011000101010
01000001010000100110101000010000101101001100010100011010000000100010000010000000000011000101001010000
00010001001101001000011000100000011010010000010101000111101000011001000000000100000001010000000110000
11011000110000100100001000000000010000010000010011000101000001000000101010000001011000100000000000001
