11111000010001010011010001000011111010001000110000100000100000001000100010010000010000010010000000110
01000000101001111001000100010101000000100000000001011100010100100110111010010000000000100000000000000
00101000011000100001110001010000011001000100110000011000000000001000000100010001100010000000010110001
10010011000000100010011001000011100001000000000010000110001000101010000100010100001000101111010000100
01100000011000000101001000010001000001000000001000000001001000000000001010000010001000000101000001011
00001001110100000110111000100010000000000101000000000010000000001110000101000001110001000110000101011
10100100000000000000000000001101001000101011110000000000001100000100010100000010000110100000000000001
01100000000000100001000100011000001000010100000000111100000101000100110100001001011101010000001001011
10001100001101000000100111001010000000000000000110000010101000100000001111111111011000110110101101001
11001001100110001100100101101000001000000000100000001110S01101010011010010010010001000011000110101000
10001100001000100000100000100001000000001000000101011000001110111000001001010001000000001001100100100
11001010010001000110001001010010110110100111001001000101100110111000010000100100011001011011000100000
01000001010000000000110001000110010001001100000100001000000000000010000010100000000000000000000000001
01000000000000110110011000010000011110100000001010010001000001000001001000000000100100100000000001000
00110001000010111010100000110G00100001111100010011000000001001011010011011100001001110100010001011000
00111010000001001011001011010111011010010111101111010011000011000000100010000000010101001101110000000
01010101100001100011000001100010000000010100110000011000000000101001101011111110010000101010000000001
00010111000000010000010011001000000101010100100010000000000010100001000000010010101000001000001000100
01000001000101000011000000100100000011001101011111100000100000110000110100001000000000100010100000001
00100000100111110000010000000000011010110000001010000011110000000101001101000000010001101000110001011
00000000000010100000011000000101001000010000000000000000001001001100100100000000001001001100111100000
10000000010000001001001110000011001000000001011111100000010000001010000110000000001001000000011000000
00100010100000010000011010100000011001001001010000000010000010100010110000001100010100110000100010011
10101010000001010000010010110111000010110010000000010100010010000111000000000000010000010001110010001
11000000000011100111001000000000010000000100001000100110001000000000101000000010101100000010101001100
01001100001100010000011101100110000001010100000000010001000000000100100000001001100110000000010000000
11101001011011110000000011000100000001000000000000011011000000001010000000000010000010001001100000011
00010001000010010010000000100110000110111100000011100001001010101101000110111000011101000000101000011
01000001000110011000000000001000000100110010001111000100000000110001010110100001110000001011100000000
01110000000000100001011010111000000100100000000010000000001000011000000000100011000010000010011100011
10100000011110000001001000100110000000000000110011000100110111000001010010000000010001000001100000100
00000010000110110001111010001000000000010000001000001001000000100110100001000010100010000101100010010
00011000000000000000001000100010000010000001001001111000100110100110001110010000001111000100011000000
01101001110100000010101110000011010010000011100101100000010010000000100001000100010001111111011000010
01010100001111011100111101101100101111011000000000000110101010011100010000100001000001001000100001001
01000101100101101000000000111000011110001011001001001000110110001101011110010000100011010100010000100
00010000000001001001000000010000011001000010101010000010010000000110101111000000010000000100000000011
00100000001001000000001000000100010000101100000010000010000100100011101010010000110000000000010100000
10000000100000100101000010110110110001001110001001000011010101010010011010001100100000001010010110100
00000100000000001000010111010000100000111001000100001010110110000011000000001000010110000101011000100
00010001100001010100000000110100110000001001011001000001010000000001001110011011100100110010100100001
00010010100010001001010000010001001001000011001000000000000100110000000010010000100011001110100001100
00000011001000001011000100010110111001101110010101001001011010000010000101000000010000000000110101000
01011000010011010000000000000010000001000010010010110110001100001010111000000001010000000011000101100
01101111101100110001010101100100000000110100000010000000011100000001000010110010000000000100100000100
00100100010011001000000001101101010000001011000111100101000100000010010010000000000010000010000000010
01100000000000100010110000010010000000100001000001100101001011000000000001010000000001100011010011110
11000000100001010101110110001001000000010100001001000000010000001000010000110110010000000010011100000
00000001001010000110010001000010000010000000101100011100010110100010101000000000000100000000000010000
00010001000011100001010110000010001000000000001000100101110000010100000000011000000101001000100100111
00000101100000000000000110010100001000101000001100000100011000001001000001000000110001000100100110000
00000010000000100111000000101000000001010000000001000100000010001000000111000001000011001000011100101
01100110111000000110000010110000100100011010001000011100001000100011100001100010110100100001000000011
01000000101000010011100110001010010001100100000001000010100000000000000101110100000000000100010101000
11100011110000000011000000001001001100000001010101000000000001010001010100010000000000111000000000000
00110000001100010100000000101010000001100100000000110010001010001001100000110001111100100101010000011
00000100000101000011000001100000001101001011000100001011001000010000010100000000100010010010000100101
00010111000100000000000000010100000000000010100011100011001100011010001101000010000110100111001000000
00011000001000101011100000110000010000011000001010101101001000100001100001001010010010010010000101101
00101000001000000101000100000000100000100000000100000101010100001000010110010100010000000001000001000
10110010001100001101001001100101010111001010000001000011010000010011010001000001000010001101000000000
00100101001001100001001001100000010000111010000000000010001110000000000110001010101000110001100000000
00101100001000001110000100110011000000101000001010001001101000010011001101010000101100001000001000001
01000000100000100000011110000110101000110011000100111001000000000010000101000000001000101000000010100
00110011011110001001100100001000010000010010001101111000001000101101000000110000010010101010001000000
00100000000110001001010101100010000000100001001011100010000011001100100000000001100011000100000100000
01101000000001001100001001110101110101000000000000101000000010000110000000000000100000000011000001010
00001110110000000010110011000011000111000111000100100010101100100000110010001000010001000000000000000
00001011011001001000010111111000100000001100001000001100000001000000101010000001001100101010100000010
10000100010001000000101110000000100100000101110010000011100110010010100010110101010100000001000101010
10010000100100001010001101000010010000000000100110000001100100000010100000100110100001100100000101000
00000110100001101000100101000001010011100101000010100000110001010000000000000010111000001011000000110
00000010001100001010000101010001001010000011010010100011001000001000101101000100000000000110100110011
10000000100001000000101100111000100100000000000000000010101010000100010010110001001110010001000011001
10000000101001100111001000100001010110000111001010101001000001000001000000000000010000100010000100100
00000001110000110000001011001101000010100100001101000010000100101000000000010011101010010010001011010
00000001000010110101010100000001001000000101000100001000001001010101101001100000000100000000000100110
00001000001101000100001000010100000001000100001000001100001100010100100001000010011000010001000100111
01100000101110000001001001001010000001000110101000000101000000101000011000000011000100001000000000100
10000000001011101100100001000000101000001100001010000100000110100001111101110110010000000010001010000
00100001010100000011100100000001000110001101000100011000000010000000100000110001110010001010000000000
00000010001101010000010000101110010011000000100000000000000010000000000001001001000000000001010110110
10100100001010100000000001100000111101000001101000000100000010000011100110101000011001001001000000010
00010000001110010000100101111000000000010000000000001010000011010000010110010100101111001110001001011
01001011101110000011101000000110000001010000110000110111110001010010101011000001001000000010100100000
10111111110000110000000000100010110100100000010000100000100010001100011011001010000000010000101010011
00000000010001110000000010010110111100010010000011001010000001110000001000000010001100000010110000001
01110000000010001110100000011000000000010000010110001010100010001011100001010000000101101110110001110
00000011000001110100000001101001010000001101000111000000000101000001010100100101110000000011000000011
00011000001001000100001001010010010001000001110100000000100010000000001010100100101000010010000100010
00010010001001101010110100000000000001000000100000000101111000001000111111000100001000001110000000100
01000110010000001000000001011100001000000100000101110000001000100000100110010000001100010100010001100
01000010010000110110011010010000000001011110000000010100001000010100001001100100010011001100101110000
10111000010000010000000001101000100000001101000010000000000010110000110000100000110000011010100001101
11100011001001100001010100111101000001000000100000101010000000100000100100000110100000000101110010001
00000100000000101101100000101001011010000010010110011111010101110111000100000011100001101000100101100
00001100001100100000010000011100110000111100001010001101110000100100010000011000101110100000110001100
10001110000111000001011110111000000011111000000100011000000010100001101001000000000111001101000011100
10000101001000010001000001000100000010101010100000110100001000010000001010010000001010000101010110000
10010110001100010000001011010000110101100000000000000010100100110000011000100000011000000000100000000
10000011010000001001010110111000100000100000000100110100111010100100010100001000100100000001100011101
