01110000010010000000010000100100000110000011100011000110001101110000011010100100001000100100011001000
00101001101000101000000011000000111101101001010101000000001001100110000000000001000101000000001000110
00100000011000001010110110100101100011000000001001101110001001000100000000100001100111110010000100111
10000000010010110001000110010000000100001000010000011110100001100011101000110110001000101000000000000
10000101010001000000101101000001001110111110010001001100100000001100000001101100011011000110000010010
10001100000001001000000001000001000011110100001000001010100000010101010110000011010000001001001110101
11001000000100000111010010011100101001000000010001000110001001001000010001100001001000000000000110010
01010000101110000010000101101010100001100100111010101001010000011100001000111000000100001011000100100
01000010000111000000001000000001000110110110000000000000001000000000000000000000000100000010000001000
00000000000100110110000001001000011000101001100100010000000100000000000110001100110111000000000001001
10010000000000001000000011000001011011001001000010100100100010010001010110000010000000100001001100001
01101000001100110000101010011000110000001000100011000000000001000000100100000000010000110000010000100
00110001011101000000000100000010100010101001110000011000010111000000100101000110000001010000001000010
00111100000010110100001110101001000100000010111010101000000101010000000111000101001000000001001100101
00000011101001000110001010000001000000000010100011101110000000000011000001110010001000000100000000101
00000010100000010100001001001000000111011110011010000100101101101001010110000110001010001000010010111
00010001100000101101000011101010100100010010001110001100100100100000011000000100011000000110100100001
11010001010100000001001001100000010000000111011101100000100000000010000110110000100100101110100000001
00000011000010000000101000000101110000010100100100000101100110100110000010010011110000000000001001000
10101010000000011101100001000001110001100000100000010000100100010000001001100100010100001001010111000
00001001100101111111100000100100010000000001000100001100010100010011010000001000010101000111100101000
11001010101010111001101111000100000010000010001001000000000100101010011101001010000010000010011010100
10100100010101000110001110001100000101100000000001100001001100101100010110000000010000010000011101001
00001010110100000001100011000101001000000001001001100000001111000000101101100100100010000011010001001
10000011100000010001010001000010000010001000000111110001000110010001001000000100000000000001001000000
11110100110100000001011001010000000001010101000000000000000000100100000001100111101001001001110110110
10101011010010101000010010110000000000000010010011101010000100100000100001110010011010101010000111100
01111010010001000000101110110000000001000100000111000011001011000010100001011101000100001110110100000
00010001001010001001010011110100111000000101110001011001000000001001101010010010000000000100100001101
00000100110000010101100000010000101010000000001000000000000000001100010010011011010111010010001100001
00000000100010001001000011000000000001100010000001000101011000010010001010110000000001000100001010000
10000100010001101000001100111100000100110011000000100000101000000010000001100001010010101100000101000
10100000001100010111000100010100001011110000110101010100001010011011100011001000000000001011100001010
11001101001110100100110000101100010100110010000101010001010100111000111000000000011000010001000010110
00000000100101010000000000010001010000000011000000101000011100011100000001000000111010110001011001000
01000100000000110010011100010000010111000000110000000010101001000000111011000000000100000011001010001
10010011000000000100000101101100001001010110010000000010111000001101111010010000011000100101000001000
00111000000010010100000000010001000010000000000010100000000000000100100001001000001100000000000000011
10010010001000000110001001001110010001100000010001110001000100000000100101001011010000100100100100010
00000101011100101100001001001000000010101001000010011000000000000011000000001000001001010010000001100
10011011000100010100010110110100101010001000010000000000001000000001100001101000000101000000000000000
00010111000000100001000001100010100011000001100101100000100000000001010011001000000000001010111000010
00000011111010101000000010011100000100000001001011000100000000111001101001100010011010110010110010001
10110000000100011001100100010010001001100000000010110000000001110000110110000000000010000000110000111
01100101010110000010000001101001001100000000001010000010010110011110000110100010000100001000101000001
00100100000010110001010100010001001001110000100110000100000010011010000000001000010000011000100110100
00000000010000101000011100101010000011000000000001000001001000000010000101100110010001010000000000101
00010010111101101000000000011010110101000001001001000011010000000000000010101110010011000100000010110
01010000010000010100100001011100000000100100000101001001100000000000100100000001100100001101001100010
01000010000111000000101010001000000101000000100000111001010001010011001111101000010110100101000010110
00111000010001011010001000000100001101100010000100010101110000000100S00011000101010001010000100001000
10100000010000110001100011100000000000000000000100110000101000001100010000010101010010000011001011011
10110001100010000000001000000000010001001000010001001000001011100000100100011000100001100011010001010
00010000000010110100110000100000000110000110000001101010011010111100010000000011010000100101010001001
01001010001001001010000001000100000000000010000100100010010000000011110000000010000010100100001000001
10100100000000000000000001010010000101010000000010000101000010000001100000111011000001100010001101000
01000100000000100000000000000010011001000100011010100001011000010000000010000100101100010101000011001
00000001101001110011000000010001110000110000100000010010010100001010100001100000000100011110100010001
00110101000000110000011100010000111010010100000000000010000100G10111100100000100000101010010100000000
01001000000101100110000010000011100000010011000100110000110100010001000010011001110000001001010010100
00101000010000101000000001000010000100000011001000000101000010000001000001000000000100110010100101001
01000111111010101000001100010101001100000001101000101110000001110000111110010000000010010000010000001
10001001110010000000101101110100000000011111010101000001111110000101001001100000001110000000000010000
01011001000000000001101100010011010010011010000000000010000001101000110011000010010001001110001000010
00100110011000101011010100000101000011000000001000100000100110011001010100101010100000010001100000110
00010110000110011001001001010100010001000000100001100010010100100000110000000010000101110000011100010
10100110100000100001010010100000000100010010000000011100001001010001100000100110000110000100010001100
00001011001001100000000000001011000100010000010010010000000110011011011010111100001100101101111001001
01010100010010011001000000000000010010011001110000100100000000000000000110010110010010101000001000000
00110010010011000010000010001101000100000001000000000100000110001010000010100000100010100000000001011
00100000001011001011010000000110000101110000000000011000110000010010100001101001110110011011010000110
11000000010000000000000100000011000100001100000000000000110001011100100100010000011001011000010000011
10110000000011100111100000010000100001000000011000000100011011000100000000101100001101100100011000100
01000000000000010000011000000000000000101001010000110110100110100110000000000000000101000000001000010
10100001111010110000100001110100000100010001001110111001000000000000010111000000010000000111010100010
01010000000111101001000001000010100001010100001000001011101100010000001100000000100000000010100101100
01010101000000000001100101000000100001010110011100110010100100001010001110101000000001100100000001001
00110000100110000100110000100001100001000000100011100010011001000000000000110001001000001100000100110
10000100000100010001000010010001000100000001100000000100100110010000000110001110000100000001000000000
01010000000101000010000011001001110010111000011000011010001000010000000010111000010110100000001100001
00000010000101100010010100010111001010000100001011000100001011110100100101001110001010010011001000100
00010001000111000000000110011000100000110001001011000100010000001000010000011000010000101100001100001
00100100001110000000100110101000000000000001000000001001100001001001010010001010000101000010000101000
00000000000001001011000010110001001001000011000100100000011110000011000010010110000000000001011010000
00011100000000000001111100000010001001000000011000011110111000111000000010100000001000000101100101000
00011001110010100011100000100100100000001000000110000101011001110110001000000000010010001001000000011
00110000100110000010000100001001100101100100000101101100101010100010000100011001110000000010000000000
11010000010000000011000100110001010001001100110000100000001010001111000010110000111100101011000110101
11110001000000001010010001000000010000010000010000010001000011000110100110000010101110100000000011000
10011000000100000000000001101000011000010100001000000010100011000010000101000000000110010100000010000
01000101000111100100100001000011110101000010000100010100001000010011000010000000101000110101000001010
01111101010000000111011101000011000000110010000000000000000000001101001101010101000010001011100001000
00010000000000000100001001000101010010010001110100010001010000101011100000100000100000000011010000101
00100100100000010001001000100000000010010001000000000101000001011000101100001001000100100000000000110
10110000000101000000111000001000101100100000011001010000100010001010101100000001011010110000100100000
10000100001000010010000000111010000100000101010001010100011000000000000000001000001000000000000000000
01001000000001000000010110000101100010000100100110001000000100011000000000100000010001001101000110100
00001010000000100000000000110010110111110010001010000100101011100001100010011000000110010100101000100
00111001000101000010000100100000100001010000110000010000000101001001001101100101101010001000000010001
00100001000000010010100000000100001010100000000100101100000011010010010000000001100000100110010000000
10010000001001100100001010000110001100101010001111001010000000110100001000000010000001101000010011000
