10100000000000011010001001111010010001000010000000000101100001001110011101000100010010100001000000000
00000100000000001001000100000000110110001000001010001001101110000000000101001000001000010011001000000
01010101001101001011101110101100000010100010110100100001000000010000000000001010010001001110000010100
01001100001001000010000010000000000110000001000110011111110000001100000000110111010001100000110101001
01000000001001110000000000000010000000110000011001000101001000101001001000000101100000000000011100001
01011000000100100010010111101000010010110000110011100100010110000101000100000001000000010001000010100
10010001111100000101000001011111000001001100100000001000001010110101000000010010011010100100100100001
00011000000000000000100101101001100010010100001110000000010011110000000010010100001011111100000100010
10011100110100100000010101001000111000000001100001011100000100010011100011001100000010101011001011111
10001000001001010000100000001000100000000100101100101001000100000001100000111001000100000000000010000
01101110001100001110000100010010110100101100110000001000100101001011100101000000010001000110000000001
01000000000001000000000010001010100111011010100000011110010111000100110011010100001000001010000011000
00000010000110101100000100011011001000010001000000011000101100010000000100000000000010001110010010000
00010111000000000100100010100011000000010000010100011110001101010101000000000100000100101010000101000
10110101011000000100000010001100000000110000111000010000001001011001010000010001010000000100011100000
11001011000100001000000101010000000000111001000000000100100000000010100010110000001011011000001000100
00000000100000001100000000001010000010110000000001001000110011110000100100000001000110100100100001011
01010000000010101001010011110011010010000000001111001100000001100011000001010011001000000010000001101
00011101000000001110100110010000000010100010001000000110100101000101000000011111000001100000010011000
11100110010000010000010101100110101100011010110000000001000001001000001010100001000001000000010101110
10001011010001010011000100000001001100000110010001010110000011000111000100110001000000011010100011010
01001100100100000000000011000100000010000011000010000001001000000100000000010000100000000010010100000
01010101001100001010001000010000000010000000001000010001101001001100011001101110000001010100000010001
00000100010010000100000110001100000000110001001000011001000000000110011100000001110000000100001100110
00111000000000010010111000110001000001000000001100000011001110000000010001000100000001000001000001010
00000000011000000000100100010100100000001010100000010101110101000000100001100010000000001001100000000
00100110001101000101001000000010100100010000110100001001000011010000000000010000110000000010000000100
10000000100101101001101101100100000011000101110000000100000001100011000011100001010110010010000100000
00000100011000101000000000001001001001000101001000000010000010000001011000101010110011000100010100101
00000001010010000001000010100001100000000010000000100000000010110000011001010010001001100001101010101
11000000000110001101000100011100000110100010000000011000100010000001000100000000110010000000001010001
01000010011011110100011000001010000100011000100001100000000000010010010001010011011000001000000010010
10101000000000110000100101110010110000100000010000111010100110000111000001000100110000111100000101000
11010001000010000011000100011110000100000111000000010001010100001000000100011000100000000010001000001
11011001000001000001100001010100000100000010010001000000110101000001000000110001001000000001010010101
00010000100100010100101010000100000010000110001011010001010000001100000001100001010000000000000000000
10000100010000001000000000010001011010000101001110110010011001010000000001000100110001001001111010010
00100000000000101000011000100101010011110010000000000100101110100000001100011100010100011000000000011
00000001101110000010000110000100001000001010000001010000010001000000000000000010100100010100011011000
11000011010000000010101000000100000000000000001000101101000010000101000000110010001010000101001010110
00000100000010011000010100100000100110111100101000001000001000100010000000000011110101100000010001110
00010000000000000000000000000000010000100101010010110101000001011111010010000000000101111001001000010
00000011000000110101001001000110010101010001100000011000100001010101000101110001001000010010001000001
00010010000000001000011001000000000010010110101011010000000000000000000000100000001000100110001010000
00001011010010010010100010000000000000010000000000001010101000100000000000000000010000101010001010001
01000001100000001101010001000000100011000101001010001001100000010111100000010100001010001100111010000
00000000101111000100000001010100111001000100001100000100110100010010111100001101100000000010110100101
00000101000001000000000100001111001010000000100010001000000110001011100011011100101111100100000000011
00100100000000101001000000111010001000011010000001010000000100000110001101100011010100001011000000010
00000010000000001011010010000000010000000000001011101000010001000101010001101011000001110100010101101
10100100100001100110011010110100000011100111000101000101100100010001100000101011000000000000000000101
10011111110100001000100010001010010100111000111000011100100000100101001010001001001011000000000010001
10100000110001110101010000001100001000010100000000010001110000100100010001110010000100000000100100000
0100000000000100000000000000001000101010010000G001000001001100001100110100000000001100000100000100010
11000000100110000100000011000000000000111001100001011100100010010001010010001100010010000100011000000
00110001000001000100100101000001100010001000000000000001000000001000011101001000110000010001011001000
0001110011000010000000000011000010000000101000001100S000000000011000001000100110000100100010001100010
00000100101110000011001000100100110001010000001000000100000100000101000001000100000100010001000000011
00110101101100001101010010110110000000000000010001000000001001110000010000010011100000000011100010000
00001000010010001001001100010010010000101101100001000111001100010010100000100100010100000000111010010
10001010010100000001101010100001011010000000000010010010000000110011100001001000000000101001000100110
01101000111000101100101100000100000001110010000001000001110000001101000100100001100100000100101000100
10000110001001001010001000000000000001000010001100000001000001101110010100100000100110100001000111000
01001011000000011001000000000000101000010100100000101101111000010010011000010010011100010000010010010
00010110100011101010010100001000010010010011101010010010000000010000000100001100100000001001001010010
01101100001000001000000000001011000001010110000010001101000100000000110100100111000000101101010100101
10101110001001001010000000000001000000111010000010000000011000100001010110010000011011000001001000000
10100111001000100001101000001000100100000110101010000100110100001001000011000100010001001100000011110
00100011101000001001100001000000001001000010010011001000100001000001111100010000000000111010011010000
11000100011000011001010000110101000010000000000010000100000001001001110001010001010001010100101100100
00010110000001000001010000010100000000110010010101000001001000000000000001011000010111001001110001011
10001010000000110100000000000000100101010001000010010110000100000000110000010100000111000001000000101
10101000001101010010001000001000110101001000110000010001000011000000100111010100001001011000001000011
01000000100001100000101110000110010100000011101001000011010000000010110001101011110000001001110100000
00100000010010011000101010000000000011001000001000000000010110100100000010100011110010000000001110010
01000000100001000001100010100010000000100001000000100101010000010000000100001001100101000000110001110
11000001101000010001000010001100101000101001110110110100100110101000001010100001010101010000001001110
01110001000111011000110111101000100000000001101100010000001010000100001000000001000000010010000100001
10000010000110110001000100000000000001000110011000010001011111010000000011000010100010001100100101011
00010000001000001010000010000000011100111100010000110100110010101110101010000010101000001010010100010
10010000000101000010000100100111010010000110000010001001011100000010110100011000000010110001000000001
00000000100000101000000100001000000010000000010110000100101010111000100000001010100000000000110001000
00000100000000000111100110110000001000010001100000010011100101000111001000000010100010011000100010100
00011011001100101010000010010011101011101101010000000110101111000101010100000000100100001000110111111
00000100011100100001100000000100010010000101000001000100100001001100100100000001011000001000000000000
00000010000110011000010000010011000010000010110000010011110000001010000100000000000000000100101110010
00001000000100001100100100001010001000000010000010100110110101110001110010010010010100100111000001110
10110010000000011001011000000000001000110111110100000111010000010001101011100010011111010111001011100
00000100100000000000000100010100010000100001011001100000000000110001000000000101000000001000110001000
00100000001110100000001000001001010011000010011010010011000001001000100100001111111011000000010000011
10000000100000100000010100001010010000001000010000000000000000010000000000001100010000011100000001100
01111010101100010000010011100010001100100001000000101000000001010010101001000001000000010010011001011
01000001101000001101001000110000000100110001000010000111000000000111110001001000000010101000000000000
01100100011100001000000000001000000011000000001010100010010001110000010100000001000000110010111011010
00000010000000000000000000010000010010010110001011011001001110000000111101000101100010100000010010010
01001000001000001001010010000101001001010000000010111001001111000010001000011010101000000100000000001
10001110001000100000010101110001010000001101110000101110000000110001001001000001000100110000000001000
01000000110000010001000010010101001100101000011000001100110001100000000000100101100010100010110110100
01111011001000001100110000010000010000001000001011100011101000010000010110100000110010011011010000001
00011011101001000000101001001011001000010010001001000010100000000010010010000000000000010001000101000
00001011110101000101001100000000000000000001001010000100001011010001010010010010010100001010010000101
