00000000000000000001000001010100001100010000100010011001010001100000000100000111100110000010010101100
11010001000110100010010000010010000000001100001101000010010100010000100100000101000101010000001000000
00000000000001100000000000000100100000000110100000000001000100000100101011101000101010100000001000100
10110000010001010011000010011000010101000011000101100101100000111110100010010000010010110000000111000
00110000001000000000000000000100000010101100110010010001001100000001000011001001000001001000000000000
00000001100100000010011100000000011000010110000000010100111100000101100001000001101010000000000000010
00000011000100010100000100000000000110010110000000010100000100011011010010000000000010000100100100011
00010000100000100100100010000011111010001011000100101010000101000001010001001010000011010001000100001
01000001100000010001110000110001010010010000001000101001001010000110010011000011001110100100100011011
01010001000101010001000010011000000100000100100001011010000101001111000001100000000110000010110010000
00001110101000100010100101101010010100000100000101100011011001001000010001000100100101000010110001101
00000010100110000000000000100110110101010000001001000100010010000000000011000000000000001110001000010
00011010010100010100110010001110111000110001000001001101000000010100101110001100001111000100001000110
00001000010010001000100001010100010001110010000111100100001010000110000000000010001000010000000100000
00000010000000100100101001000100011100100011010000100000101001011000010101000000101100100010000000011
11100000000000100000000100110000101000101100101010100000000011000011011001010000010001001100001001010
01011100101010001101000100100001101100010000101010001000101000010001011001001000000000100010011100000
00000000000001010001000000101100100100011000000000100010011000000101100000000100000000000000100011010
00100000001000001001000010100000101010000100000011110110000001000000100000110101100011110110100000110
00000100011000010010010110010010111110010010010000001000011010000001000100101110000001100000001100010
10010000010001000100111110000100000000100000100000000010100010001000000001000000100000100010011100100
00000100000000100001100110010110111000000000011000011011000111000010101010000000001001100000011110110
01000000000101011100000000101001101000011100100010000000000010010110111001011100001000101001001000000
01001000010110100001001000001100100010010000000100101010100110100010100000110000000010001110000001000
10000000011000011011000010010101100000000001100101100111000111100101001000000000001010010100000100101
00000000101001110000000001010000101000000000001000000011011000101001000010010000000100100000001000110
00100000000000001110110010000011110010000011101101100011011000100000111001000000001001010001000000001
00100100000000000001011000111001000100100110000010001000000011000001000001011000000010100111100101100
00100100110110001011001100010000100010011000000000000000110010000101100100000101011010001000000001000
00010100100111001011010000000100001011111001010100001000110000100000111010000111000010110000000000110
01100100001010000110001010001000100000110110011001100010101010000000000001000101000110000100000111000
00000000011100000000111000100000010011001001000001100000000000000000000000001011010001110010000000011
00010001001010000100100011001100100001001010010110100010011000110000110000000011001100000000010000101
00000000000110000000000010100010010100100000000100000100000010001000000111001100000010000110100000011
10100000000011011000000100110101010000010100000011011110000000000010001100100000101101011000011010000
00001000100001000101000001011100001100100011000000100110011100101000010000110001100010110000001110000
01011101101000000011000001010101110100100101001010100000010001010101000000000000110000000010000000110
00101111000101100100111000100000000001000011001100110101001001000100100000000000001011000000011000100
10100101000101010000100000000000000000111010001011010000000110001001001110110000101011100010110000100
00000000100100001000000011000001001000011010000000011100010000111000100101001111000111000100001001000
00100001010001100000101000011010011111001001011110100001000011000000100100010000100100100001100000101
00001010100000000000110001000000100010111100000001001100001000000S01100001001101000001001011000111001
00010000000000000001010100100000110100100010001000100100110000100011000010010000101011101011001000010
10000001100010010010110010011000001100000000000100111010100100001100000010000010000000000001000100001
01010000110101001000001101000000100000101000100000100000100000000101000111001001100010000001001101000
01010010010101011100100001110001010001101100101101001010101010101010011001000100001100000101010001010
10000100101001001110010101100010101000100000100001010000000001000110100000101000000110000101011000000
00000010000100001001001011000000000010001000000100001001001101011101010010001100000100011100100000100
00001100000100011111000000001001000010010000000010000000000000010010000000001100010001000001111011100
01111110110001000100000001110010010000100010000000001100000000011000000100010101100010010000110010001
10111000000010000000000011001100000000110000100110000110000000000000001110000111010110010001000111001
11100001000100001011001010011001110100010000010010000010100100100010000000000001000001100010000101110
00100001010111010001011010110100010011001100010110010000000111011010111010000000111011001010110000100
00001000001011001010001000100110000000000001011010101100001000100100000010100100111000110001101000100
00100010001001100010000100010001000010110011001010011010001000010000000000010000000010011000010000000
00101001011011010101100011010100100011010100010000000000010100000001000000100001000000000010010100101
01010101000001110100000001111001001111000100010001010010000110010101000001010111000101100001011000100
00010001010011110001000010100101000000001000110000110001000000000000000110011000010010100000100100000
00001001010111100000101100011000011001110000110011100101000000001001101100100001001111001000100001010
10101101010010000101010000000010011000100000001000100100000000000101000110000011000001001010100010110
00001100100100111000100010000110011000000000010010110001000010010000000100110001011001100001100001100
00001000000000100000001000100001000000010001001001000010111000000000010000001110100000010000000010000
10110100100010000000000100000111010011110000001001000010000010000010000010100111100000110000000100000
00000001000110101010000100001000100010000011101101000001010011000110000100000010011000001010101100110
00000101110000001110001110110000000011110101101000100010100000000010000011010010000000100110001100000
01000000000000100100110010101000000001000100111100000110011101010000000101000000001000110010100001101
00011001001000010001100000000010101010001100100101111000000000011000100000000011110001100100010000110
10100010000001100010101100001111011000000000000100000100001000010000000010100001011100100010011000001
00000000100010000011010001000010000000100000000011001100100000100100011101000000110100011100000001010
00000000100111000000100000000000110010110001011001000001100110101000100100001010000111000000100100010
01000101000110110010000000001110000100001011100000101010100000011011000010000000100000110000000101100
00010010000000000100000100011110000111001000110000001000000100010010000000011010100000010010110100000
00000010100100000000000001010001000000000000000000010110100001001000001001101001000001001000000100010
11100100010000101011000000010001001000000000101101001000100000100001010000101000101101001001001110010
10000001001100110100001000011001000000011001000000001100111110001100100000110100000011000000000011000
000101001000010010000001100000000100100G1010010000101100100111010100000100001001001100000010000010001
00110000100000010000000000111010000011110101011010000000000100001000001000111000010101000100001100010
00010010000000100001110000101110110100000000000100100011101100000000000000000010000111000111111001010
01000001100001000000000101010101101010000000000110001010000110000110000000000000110011010000001110100
01000011100011010000000001000010000000000111000001011101001001100001000100001110100001000000011011100
00110001000000001000000011100000100111000000000100000000000100001000100010010010011011000001001001000
00010000100000010010000010000010011100001000101010010000100100010000001011001000000010010000010011110
00000010001111011010010000110010010110000100011000011010000000010011100111100000111001101000000001110
11000010000110001100001000000011001010000000100000000110000100111010011000100001000100001000010100110
00010100000000000001100011100100101100000000000100001111010100100000101000010011010100000000000000000
10000011101000000101111000000000000001100001000000100000111110010000000101001100001010000011100000000
00001000010111000110100111100000001100011000101000000000000000101011011010100001010000001010110110000
10000000000010010000001000100001000010011001100001011001001000000000011000000100011011110001011101000
00000000110110101001000000100010001101000001100000000000000111010000010100101000110001100000010000000
10100010001001100001100101110100000000010110100100001000000000001111010000000010101000000010000000000
10001000010000010011001011001100000000010010001001100000000100100000010000000100110011000110111011001
00000001001100000001010010000000011110010010100000100000000001110100100101010001100010000100101011000
00000100010000000110110000000010000000001110001000000100100100010000011000010110010000110010000100001
01100100000000010001100100000001000100000010000000000100011000000000010100010010010100100010001011110
00000101000000001000010010111001001010100111000010000100000100100001101000001100000100000001001001000
10010000000001000000000010000010011010010010000000010010010000010010010101100001000010010000101000001
00100000011100100010010001000010010111000000000011000111010100010110000100000110101000010000100001000
10001111010010000101010011010100001000010101000000101010000000010001000000001010000000001000011010001
00010100100100001110000000001000101011010000011101000001010100000100100110000001101000101000000000100
00000001110100000010001000001101010001001001100001000100010100110000000001100010000000101000000001011
00001000010011110010011000101000011001001000000001101001000100010001000000010011100010000010110010100
