10000000101100000001000010000000110000100100010001110100001100100001000000100101000001100001110101100
00100101011100100000011100000000000000001001010101010001100000100110010000100001000010001000110010010
10000100011001010011000011011000100100100000001000101010101000011111000100100011000110001111010110000
00100000001011111010011000001010001000000010001000000100111100000100101000000100010110100000001011001
00110000010000000000000010000100101010100001010100000011001010101100000000110001110000000010100101010
00100010110100100000100000001110110010000101001010000000000000000101001011011000101010010010011101101
10000100100011010010001010000000011100001000111000001000010001110010000000000000010110010001000010010
00000001000110011000100011000000011000000001000001101101100000000110100011000001011110110100000010011
10001110100100001010001111100010011111100010011001000111101000000011000000100011000000000000100011011
10001001000000000110000000100100000100000000000001000000000010011001000000010100000000010100000100100
01000000011100110000100001001000100001000000000010011000000000000100011100101100100100100000000000111
00010111000100000000000011100010011001100010011000000001010010010000110001001000000G00101000000001000
10000100101011110110101110110100011000101001010011000000001000000000100010000101000100101010000000010
01010110000000001000011011101100000001001000000100000000000001001000010000010100110100100100010000101
00000001000001110000001010000100100001100000000010010010001100000001100001000110000000000000000000001
00000000000000000000010000000100010100001110000000110000010001000000011000110001000000101010001000000
00001000010010000100000001000100000001001000000011000010000011000011000011010001000001010101100000011
11000001010100000000000000101010000110001000010010101010010010110000010010000000101010000001000000000
00010000000101111100011000000010100001000001000000000011011100001100010001000001001000000001100000010
01110100000010100001000000000010101000100100011000000010001000000001000110010000000000100001100010101
10100000010010011100010001101110000110100001011000100001001110010000000011110010011101000011100011000
00000100000010000110100001110010011000110001000010100010100100010000000000100101010000000100000100001
00000101010101001000011000011010100000000000101000010011000000000000000000011000000101001000001000000
00110101111110000010001000000101100000000000000010101001000110000101000011100100000001101101100010000
00000010000001001010110000101011100100110000001100000000001001000100000100001000001100000000000000101
10101000001111011001010011001000001100101000000110011011101000000111011101100010111110011010000101000
10S01001100110011000010010110000110000001000010101011011001001111010011110100000000000011000000110100
00100111001000000111000111000000001010000010100000001000000101101010110110000011001000100000000100000
01010110000000101000001010100010101001100100001110000100100010010001000011100000110100010100000111110
00011001010111010011001100010101000000011000000101010001010000000001100101000010100101000100010101000
00010010101000110010101100010010101000001001000100000000000001101000010010001000011000001101101110101
11000010000000000000100110000100001000010100000100011000100100000000100100000000000000010010110010000
01000001000000010011111011000001001010011000000011000010001000010000000100110000100000000010101100001
00001001000011000110000000101000010100100000001000000000100000000001010110100010011011001000011000000
01001101110000000011000000001011001011010000010001000011001010100001100000000010010010100010000000000
00010000000000000010000010111000000101001000000000001111000000000100000010100000011000000100010001010
10001100010100000100101000010000000111101100000000010000100011010001000000001110101100001000010010101
00100110000010010011110001000000101001011000000000000100100011000000001111011010010101110000000010011
10011000111110010000100110001010000001000000000000010000010000110001000010000010001100100000000100001
00000000000011101110010001001010100100101000101000010100000001000010001000100000101000001011010000101
00011000000111001100100000001110000010000010001100010000000000000101010101011100000011000000101110100
00001001010001000000010000000011000110000001101000110000101011010101001100000101010011100101010100011
01010000001000000000111000110110000101000010000010100100000010010000101000000100001110100100000100100
00111000010000010110000110100110100110000100110001010100000010000000001000001000110000101000001010000
00010000111111010000001100010001110000100000011100000110011001100111001001001001110010000100001011101
00111000100010100000100000010000001001000000100000101101000000100001010110110000000100001000000000001
00100000000101101101001010011100000101010001000001010110000000000010000000110101000000100001100101000
00000100101100110001010111001001000000000001010000000110100000000100100011100101001110000010101010000
01000010000011011001110001111100000101010111101010001001000111000100001010000100000010101011110000100
01000010111011000011000100000000010110111010000000101100000000010100010110000000000000010000111000011
00000110001010110011100101100000100000000000010000010011111110001010001010011000000101110011100001001
11100000011001010010011000000001100100000000011001110001000000000001000001000010010000110101101001001
10000000111101010011000100111010110100011010000000000101000000001110100001001010010010000010000001001
00110100000010001000000101100000001100100010100011000000000000010111000001111000001110110100000000000
01000001000001001100010101010001000001000010110011000100000010000000000001000110000100001101100011100
00100011001000001000000001000100000101110001100001101100100100011010001001011111001010011000000100111
00000100110010101000001001011000010100001010010000100010010000000101001000011000001001000101101000001
00000000001000010100111110001000010000001001100100000101000011000001001010100001010101100000000010011
00001000000000000001000101100010010000001000011100110000100001001100010000110001000010001000110001001
00000001000100100000010100000101000101011001000101100111000100001100001110000111000001100100000010000
10000011001100000001010000101110010000001001000001100000001101000000001000000001101000000100011001001
00110000000010000110100000010000000001000011001000001000111001111000010010010010000111010000000000000
00110010100001001100001010000100101101010000100001001001101010001011110010001100001010010000110100010
01100000000000010000100101000111000001001000000000000000000000011010100100111000100001011001000010000
00011000101000101010001101000010000000011101000001000101100000111001001001000000100000000000010011010
01000010101010001110000100000110010100000011000111001001000111001010000000000011000010100010101000011
00000010110000001001010000001000010101001110100001001010001000010110011111001111100001010000010001000
00010011100010000100111100000110011010110010100111000001000100101111001000101001101101000010000001000
10000110000001000000000000001000010110100000000100001010010000001000001010010011000010111000011001000
01010110010000010000000000001000000010000111010000010100000000100011001001100001000000100000011110011
10110001111010100001111000000101001101001000010000100000101100011000101011010101000000110100000010000
01011000010010101001000000000001011000000010010010001010010111010001000000001000010000110100000000101
00011011011001001010000101110100110000110010111010100000110010000110110000000000000000011100000000010
10000000000010001001000000001011010000000001010000101100100000110110000000100000000100110000011001010
00100101001000000111001010000101000000001000001010010000001000010100100100010001100000001011000000001
01000100000000010000000010110010001100010000100010010010101101100000001001100011000001100000100000000
00000000011000000001001000001000011000010100000010010000000000110011110000100000001100100101000110010
01000100101010001100011000110010001010000100001100000000010001100011100010000011001000001001001010001
10010000100100000111010011000000000001010010010010000000101010100111111000001000100011001100100100100
00100000100111000100000001000100001000101000100010001100101110000010010000000100100110000000001100110
00000010001001000010110000000000101011000100001100101000010101011100000001100101110110100010000000011
10000000100110100100010100000000001010010000010101001011100001000111001000010000100110001000000010001
00000000001001110100010010001000111000011010110101011001000000000010001011111001001000100001101000101
00000000000000000010011000010100100010110101001000100100001100000100000001100000100110001000000101001
01001000010000000000110000010100011101000110011101000001001000001010010000101000010000010000001000010
00001011000000011011001100010000010111000000101000010010110010011001010010000000000000000001001010010
00000000110001010101000000000000010000001000000000100000010011111010100101000100000010010001100101000
00110000111000011100001000000000000111010010010011010100001100010011110101000000000100001000000000111
10000100010110000110010011000110000010100100010000100110000000010110000010001000000001100000001110000
00000111010100110001010000000000000010010000011001000000010000010101000000011000000101000001000011001
10011000001000001000001000000001010110010001010001001000000100000011000011111010110000100001000000000
00001010001000001001010000110011111101100100001001110101010100100010110000000000000010000010010000010
10100000011001001100100100000001000000000001000101000001000100001010010100000110100001100001001101010
00101010000010100110100101000111100010110000001100000000000001000010100010011010000000100000001110010
00110001110101100001000000001001000000010100010001011101110000110101100010101011100001011000001100100
10000011000100001000000001000000011010000110001011000100001000000000100001010011101000000101101101110
01010000011000000011010100010110101100010100011011111001010000011000001111110010001000000101101101111
01010000101000111001010000001010000000010000000100000111000100010100000000000000100110010011010011001
10000000001010000010101100100011010011000010001000110001100000010011100001100000000000010000001101000
00000010010000010100010011000000100110100010010000000001010101110000110000110100101100000100000100001
10000010100110100000010010000010000001010000000001000000000011110100001011101000000100100100000010011
