00001111010010000110100101000000001010011011100000100100000110000101100010000100011101010100001011100
00011011000000001000110001000001100000101001001010001000110001000000000100000100011010011001000000011
00011000000100010101100100000101101000000110000000100010000010001001101000000001101110010101100011001
00100000101000010010011001000001100100000010101001100000000110000000000010101000001000001010000010100
01100000100111000000001111000000111011011110000100100001001111101010100000011001000100100110000000001
01000101101100100000000000110101100000011011000110101100100010001000100010100000001010101010010000000
00000110000010100110001100110000100001000000010110100000011001101100011100100100010000011100000100000
01000101110111000010101101000100000100101000111011000010000011000111010000000000000010000100110010011
00111000010100000010001000010001001101000000001010001101101100010000100000010000001000100000001100000
00000000010001000110011110000010101000010000000000010010100101101000100000001000000000000100000100000
00010111100001000000010100010001110000001100000010000000001001000000101000001011000000100001010101011
10000101001100100110011000000100010000000001101110000011101110010001001000000010100000101000000001010
00000100110101000100100010101000000010011000000101100100000010011010111101000000000000010000010000011
10110100001101101101000110101000110001000010000010010010101010010110010011000000010001001101000010100
00000000010000010100010000101101010001001110100000001001000000000010001000010000001110000011011010100
10000010110101000100001000000000000000000101101000010001100011011000000001100011100000000110010001000
01100000000011000000001011011001000010010011000100000010010100000000101000000000001010001000100001000
01000000101000000101101100100001000010000000010000000000001010000000000000000001100100010001100001001
00000110100010100010110000000110100001010001000001100100000001000110100110101010000010000101010100101
01000010000110000000100001100101100011000000011011011010001101110000010001001110000001000001001010111
10010001110010010000100110100000000001011100000100010101000010100000001100000000000001100100000001001
10000000010101000100011000001110001001100001000101000000101000100001110110000001000110100001000011000
00001100001000110000000100000000010010000010000001101001101000010010010100001011101100000001010001010
00000000110010101000101000000001100001110100001110000110010001000000000110100000000100000000001000100
10010000000000000000000100001011101001100010000010000011001011010101100001100010100000100001001011010
11000001011011000101000100010011011001100101100010010000011000110000000001001000010100001100100001000
00000101011011000100010110001000001000010000000111001001000010010001000001010010100010010100000110110
00010101001100010000000000100001110001000001000101000101000111110110000000000110001100011000011000101
10000000000101100100010000110000100001010001100011000000000001011000000000001001000000000001111011110
00000101010100100010101000010000000000111000100111000011000001000010010010001011101000100000010100010
00001011001001001000110100000010101010101001000000000000000001000011010100000000100101000001101010001
10000000010000000000111000000101000011000001010001001001000111011100110110001000101010011010000010001
10110000000000000110000001000001000000011000000100000001100000000100001011000100101101001000100001011
11010111000010100101010000100011001001001110001000001001000100000000011000101000100000001001010000100
00100010001000001000000001111000000000001110101001011000000000001011000011001110000011000000110010100
00000010000010100100000000000000100010101110000000001100111101000011000100100000000101000010001001000
10000000000000101110001000000100110000000011000000000000100011100000100010000000001000000000001110011
10000010010010000010000100100100001111001000000000001000000010001000000001000111010110000010010101000
10000000100011000000100000000010001001010100001000000010010100011000010001011101100110000100010011011
00000100101011000010001000010011001010101001000000010000100110010001000011001011000000000101100000110
10011101011000000001111100000100000101000100000101010001000110110110000001010111000001010010000100100
00000000001000000100010000110001000000000001101101000100010000010011001001110100010000001001001001100
00000010000000000000000000010111000010000010100000010000101111000100101000101000100000110000011100000
01100001000010010000000111100000001000100101000010010000010000010010111110001000100110000000001010001
10001000101000000001100000001010001111011001011000010010010001100000100101000001011100000000010000000
00110100101011000000001000000011101101000001000000000000100011011100000110000011100000000100000001000
11101000001011000011100010010000001001000011000001000000000001001010100001000010000001000100010011010
10010011110110100000010010000000011001110010000010010000110010100001010111001000100010000000010100101
10001100111100011100100010000100000100100011000110000000100001110110001101100011000010010000110010101
01000010000001000000100000000000000100001000001100010000000000000100010000000100100001010110010100101
00000000100000000101110011010000100000000000001000010010000000000100100000010100011101001010110001110
10000100011000101100100010011111101000000110000100101010010110001100100000100000001000101101000100000
01100000101010100001100000011000010100111010000000100000001110110110011000000110001000101001000001010
10100000001010000010101001101000010110110011000001110100100001000010000100001110000101000100111100000
00000101000010000110100100010010011100001001100001010100000000000000101000100000100100101000000000111
10100010000000000110000010100000000000110100001100110100100000010000001001010110000000101000110000010
10111100100000100000010001110010010000101100011000001000010101101000000101110000110010000011000100100
01000000000000000000010101001001000100010100000100000000010000000100010010000000010000001010100000001
10000001001000011010000001000110000111110101110000100011100001101001100001000000110011010101000110101
10000100000100111010000001010000000001001000000111010100000001000000101100100101000000111010000001001
00001100000101001101000010000000000100000100001100010001011110001100000010011000010100001001010000100
00100100000111000100000110111100000000000110000100010000000001000000000111010100000010100011000000101
00000000000111000100000000101010000001000000001110001110000101011000000010101011001101010100000000010
10000000001000000011000001100011100000001101100000011000110111000010011000010010100000101000010001000
10000000000000010010100100101100001001000000001000001000001000101100010110000011100001100100000000000
01110000010100001000010010001111000000110100100101000000011010000001011000000000000100101111011100010
00100000101000000100100100000011011001001001000000000101001000001000000000100101010110100011100001001
00011101000010000000101000010000000010000000000000101011000000100100000001011000010100001001100000000
00010000001001110011010100000000110000000101001000010100101010000000010000000010100001000001010100110
11110001101100000100111110100000110111101011000100100101111100100000010000001000000100010010000100100
00011000110011000010101110010001010001111000110000100000100000110000110011001000010110100000010010001
00100100001100100001110110100000000100010011010011000001000000000100000001110010010101000011100110010
00010000100100000000111101000101000000011010010110000001010111000101010000101110001000101000001001100
0001000110000001010000000101000000001000111011000110G101000000010000100001000101000011100010001000000
00001010000100010000110010000010000000010001001100100001010000001010001100100101101000100010000000011
01000000111000000010001110001000000001000100100100110110100111010000000100111000001000000000010001000
00010000000000000100100110000111110000010011001000000000010100001010101011000000000101010010111110010
00100100010011100100000000000000011000010000110010001000100110000000010100000000000001000000100101110
01100100101010110010011101100001000000010001000000011101000000010001100000100000010000000001100011000
00100000000000110110100100001010000000000111000100000000000000000001000000000000100000001101100001100
00011001100000000001001100101000000001100000100000001110000000010000000000000010000100000000001100001
10100010001001100000000010011000000000000100110100010100100110000100001001100111101000010000000000000
00010000001100000001101110010010000100000101001100000001000100001110011100011000011000001100000010000
00000101010010001000000000110110000100000101000000000000000100100100100011001000000000000010010000110
11101000000000000000000001100010010000001000100110010101000011000010111000100111010001000110000010001
11100010101010000001000110111011110010011100011001101000001000100001001001110000000110110001111010000
11001001111000010001000101101000000010010000000010000001010001011101000000100010100000100000000000110
10000100011011010011010100000100000000110010010000101001000010000110010110011111000101100100110101110
10100100000111100110011001010001011111000100001110101110100000000010011000010000110111000100011101000
10000110010001100000000000011011010111101101010000000000010000001000000010101001010011001110000010110
11110000000001010000000111001001001011100000000100000001101011001010001010100000010101010000000000000
10110000110100000010011000000000000000001010001101000001101010110101001001110000110001100111010100010
00101101000000100000000000010011011000011011001100100000000000100101000100000000000000010000001000011
00110100100000001101100000100001100000010001010101000101001000000101101110010110011110001000110111100
00000101000011111010110011010110000010000101100001100000000101000000100110010000001010100100100110101
00010001000010000010000101010000010100001101000110001100010001001111000100001000101101100011011000000
00010000100010000101000001000110000010010001010011010000101100011000010000110010101010000001000000100
10010001100100000100000001000011100010100010000000010000101000000001000000000010010000000101011000000
100000100010010000000000100010011000001000001100000101100100000000100S1000000100000000010010001000101
00011010000100000000100111000100001011100010000010011100000000100001001000100111000100000010000000000
11000110101001010001000100000111000010100110111010110000000111010110000010010101011100010100000001101
