00110000110000010110001100001011001000100011000011101011100000000011000110100000000110010100001000000
00000010100000101001101010100010011000010000111001100010011000110111000000000000100101100001100000110
11001101000000101100101010000001110000010000011000000000000101110010000011100111000000100110100000101
00110010001000000100010100010100000000100100000101101000000010001001001000110010110011000110001000110
10100110110011101000000010000100000001100010101010001000000011000100111001000110011100001110010010001
00000000001000001100001011001001000100011110010000011000011100101000001001101100100110010101000100100
00000010101010100000111010100000000000010110010101010001001100000000010000000001001100101000011101000
01110110001110000000111000000101110000100010000000010101000100010100100010011000011110000000010001000
11000000010110000010001000000000000011000000001001000000010010000000010000000000100100000000001000000
10000111000010000010010010010000011000110100110000100001010000001101000100011110100000110110001000000
00000100101101100111001001000000000010001000111011100011000011000001001010011110101000000000000000000
00000101010001010100100001101111110010010000010101000001011000000010110110000000001010110001000000000
01010000011110000000000011110011100010011000010100001011000100000000000011110000000001100000100001100
00010011001000001001001001010000001100101101000010000110101000001000100000000000000000000110100000000
00110101010011100000100011001000100101011011101000110001011000011000000000001010000010000110010000101
11010000000101101100011000010100100001000100000110000010000100000001110010000011000001001001100001011
00010010001011001110000000001000110101001101000001110100100010110010010101000011000001001000001000011
01000000101000001101001001110000000001100101000110000001100000010100100000001010100111101000100010101
01001101000001100010000100011000000000101100100011000100100010000010001100110100000000000111011000000
00110001000000001100101000000010000010101010000100000001001110001000100010100100011000000110100101110
00100000100000000100011100000001000000010000010000100111110101010001000000110000011110010001101100000
01110001000001000000010100110000011000000000001000110000010000100110000011100000000000110000000100101
00001001001111110110001000101001110001001001100010000010010010011011010100010010001011000010100010100
01100000010000001001000110001000100100010000000100100000100001000000010000100000111010111101001001000
01001000000000100111000010010001000100100010000100010000000000100001001000001000100000001001100000001
01000000000000000011101000011011000010000001000000100010100010010001001000000010100000001101000000000
01000011001000100001010001100000100000000111000100000100000011010010001000010001010101000000001000000
01110001100011001000000001010000010000111100110000011100001010000010011101000000000000000010111000010
00000001110000110000000101001011000100001011110000010010110000001011000000110000110001100000100100000
00000001001011010000000100111010101100000100100010010100001110001011000110100000100010100010010100000
10001100110000000000000100010100100010000001010010010110100110010000100101000000000000100010010000000
11001101000101010101001001101000000110000001100000000001000011100000000001000010100100001000000000000
00000001000100000100000100001000100010101010000100000100000000110011000100000100011001000010000000000
01101000000011100000000000110100000100001100010010000000001000000101000110011000010000000000011000000
00011000000000100000001010000100100111000000101100001000100000011100100001010011011000000000001011111
00000110110011111000000100000010010000000100001100010010100110000100011011010101000000100101100001000
01110110011000000100110000000001011001000000100100000011000101110110111000110010100100100100000000000
11001001100100110110000000010100011100010001000000000000010000000010000110000110000110100101010101110
11001000000000010100011001011001001000101000110100101100000001111000001000000110110001100100001001000
001100000000101000000111001100000010010G1000000000101000001100111100000001000100100000100000000100000
10011010101000001000000000000000000110000000011100101000000001110000001110000001110000100001001100001
00010101000100100101000111000100100101001010010000001000010010000011100100001000000000010001000100000
00010000000000000100011100010000100000010001110001000000000000001100010100000100100001000100100100000
01000000100010001000000100000000000010001010010000000010001010110010000101100000100100010000010100010
01110000000001100100101000000000010000000001010110000101100001011001100000001000000001101011010010001
00000100101000011001000100100101001001001100000000001010111010001100010000000110001000010010111010100
01000110100000010001000001000101010000101001111110101000010011000010111001000100110000100001110110110
00001110001100000001001000001110100100010101100100101000011100001100000000100000000100100011000001010
10000000000000001101000000100110000001100010100000000010001000100101000010000001000010000001100100000
10000011001000100000010101100010001001101111100001010101101000000101010101000010011010000000010110100
00000010000100000001110100001000011100010000010100010010000011001000010001001011110000000000100110100
10100000000110100000100000001001010000101000000010100000000001001000000000010010000000100010001101001
00010101010110000010001010100001001010000000001100111000000100110010001010100010000001000001001110100
01100100111001000100110101011001110000000000000001011110001011001100001000101011001111100010111000111
00000001101101000000110001000110000001001000100101100001001000011110010000000001101011011100101001010
01110100010100100101000000011001010011100011110010000001010100100010000000111001010010011000000010001
00000000000101000000000000000100111010100100100001100100010000111010100100000000011110000000001100001
00101010000100010110101111111010000001010101001010101000000100000000100100001100110010000000100110000
00011001001100001000110110100000000000101101101000010101001001100000001010101010000100100100000000000
10010001011100000001100010000000011000000000010101101000000010000010100100011011000110000000001010000
01010001001000010000000100001000010100100100011000001011000000001001000000100011101001000100100111101
01011000100000000010100000001110000101101011001100011100000101000000010000000011000100001000101001001
00100101100101010110000001000001101110100100000001001010101111010100110000101100000100001100110000001
00001110101001001000110000000111000010100001101001100010000111000111010101010100000110110100101000001
10000010000000110010000000110000011011100010010010010000010100101000100011001010001110110110000000110
10111101001011000010000110111001000111000100000010000010011011100000010001101011100010001000100000001
11011100000000000000010100001000100001010001110111011000101100010010100010010000111011000000010011110
00000100010000001000000010110000000101110100001001010000100000110000001010111001010000010010000111011
10100110000000011011001010000000000001100000110011000101001000001010101010100000010000010110100100011
00100010000001010000100010000001100100000100100001000000110011100000000110001000000101110110100110000
01110001010101011010001000000001010010011001010000001101000110100111111010100010000000001010001111000
01000011010000101000110010010110000101000000010100000010001000100001000110011101000010001100000010100
00100100000101000001001100010000101000000010000000001110000000001110001000000001001010011110010010100
00101010100011000000000000100001000101000100100101001001001000010001111110000000000101100000000000100
00101011001000001110001000001001000101100000110011100010000010000101000011010011001100001100100101010
01101110000000010010101000000100000000000110000001000111000000111000000001011110011001100101000011110
01010000011011010000010001011000110010100000001010100111010010011000100100101110010000011100001100101
00001101100101010111000000000000101010001000111100101000011000000001001101111000100100101000010001000
10010000011010101000011011011000000101110010000001000000000000100000000101100010000000010000000110000
00010010000010000001000100110000100010000010000110000010100101011101011010010110100001100001000110100
10000100000011010010000010101010111100100100010001010000001101000110101000000011111010010101011000100
00111000100010000001001100000100001111010010000000010100000010000101000100000101011000000001010011100
11010000000010100010111001011100100101001010010100000001000100000000001010000100100000011001010100001
00010110000000000001001010000000000110001101000000010001010000010001000000110010010001000010000000100
11000000110010100001000000101000000001011110001001000100000011001000000110001100000011011110000001000
00001100001010001100100001000100000100100100111001001001000001010010110010000011000110011000011101011
01000100010011000000000010000000100110110111100010000000100010000000010000100010000001101100010010100
01100100000001011101000000000100010010000111110001110100111100010100100010000000000000000000010000001
11100010011010101000000000110000010100000111000101001100000010000100000000100001000000100010100000011
10000000010101000100101100110000000110010000000000101100110101010000000000000010010000010100001001101
000101000000000100S0010000000000000000000000000000010000000000000100100010000010000011000010000000010
00110000000101001000000000100001001010100000110001101000001010110001010000011000001000000001101000000
00010111011110000001110011000010000010010010110000110000000101010011000100010010100001010000011100000
01001100110000000001000101101000010000000000010101110000010000010010001001001100001010000010000111110
10000100000101010010010000000000001001101011111101011010110011100000010000000010010010010001000000100
11010010110000111010000110110000100110100010010001101000010000000101000101110011000001101001100100110
00011100101100000000000000000110000100100000111000000000011000110000010011001100000000000000000111001
10011000000111000000000100100110001011100101011011000001011000001001100100001111000100000001000000001
01000101110000101100100000001001000001010100010000000100001000100001001000011001001010000000000100111
11000000001000000000001000000111011100001000000110011010100000010001011100010100000100000010001100001
01101010101000001000000110000010001010100110100010001001010110100101001000001010001010100000000011110
