10000000010110100110000110110100010000101010010000010110101110010000100011001111010100110000000010001
00110101011101101000000000000011100001000001000100000100100000100010001001010010010101100000100001010
01011000010000000011100000011010001000100000011101011000110101101101110100000101000000000011000000000
00000001011000110000000101000000001000111000010000000000001101100100010001011001000010000001100010011
01000001001000011011001000000001001110010011010000001010001100001000001010011101011000011010000010110
00111000100010010000101000000000000000000101000000010000100000001001000001111001000100000000111000001
10000000000001100000110000010000001011000010011001010000000000011011000001000111010011010000000010000
00100010101000101000101010100001010011011010010001100100010001000001010110110001000001010010000010000
01011010101000010100110010000010100010011010110000100101101000001011000000010111000010110110001010011
00100000001011100111000000001110000110000110110000100100010101000001000110000000001000000100101000000
10010001110000101001110000001000001000100010010000101010111011010000010010000010000000010011000011000
11000000011000111011000001110110100000110011100001000000000110000000000000010000000011001000011000000
11110001000010100100010011111000001110001100100000100111111010011100000010010010000000100101101001110
00001100101100000010001100100101000100010000100000010100000001111010000001001000110010001000101110000
00010011001010100011000001111101000000000011110001000010100001010000000000001000000101000111101100000
00110000110011000001100000000010101010001011000101000010000110000111000000000000111001100001001000001
01000000101011000001010000010000001110110000010100111010000000000100000110000011011000010011000001000
10011111001101101000001000001001110010100000000001010000011011100000100000001001000000000100110001011
11000100000001001001100000000000000010110010110001000000000100011000010000100010000111100100000000110
00000000100101001000000100000110000100010000100110001101010011100000000001100000011000010000000010000
01100001001001000000001010001110000010001010010001100100010010111000010000011001000000100000001010100
01001100100100000001000000000010001000100101001100001001000101000011111001001011100000111101001000001
10000110000000011000100010110000111000000001011000000010010111000001000111000001110101010011011110001
01010101001100000110001101111001101001011100010000110001000100010010010000001001110000111100000000111
00000111000110000000000100000011011000000100001000000010001101100010001000000111000110010001000000001
10001000100000101001001000000001101001101010100010100110101110010110010110001010000011000101001000000
01110100011010101000100010011001000101001011000000000011000010011010000000000000000000000100100110010
10110001000000001001101100000001111110100001010011000001101000000100000100001010011111000011000010010
01101010110010000110010001100001100000000001100001010000000100010000010001001000101110000010100001011
01110010001001100001010001010001000100010100111010101100000000001001111001101001011000000010001100000
01000000100010000101000000001000011000110010110000000101110010100010001001101010000010001001001000001
10011000000100000110000010101100001001100011110001000000000100000010011100000101000010000110000100000
00010010110100000011000110011011010000000101101101010001010110100011010010110100000001100000011101010
10111010000100000010010000000011000100010000000100010000100010101000100100000000001001111100001100000
00000010110000010000010110000010111000111100001011000100010100000001110100001110001000001011000001100
01010100100000001100100000010001001000000011100000000100001100100010000000100010100110001000110001000
11001000001001100100000101100001000001100000001000100111000000110000001110001110000000100000100110100
00100000000000000111001011010000001001111001001010000010000001001001001000000010101100100000011000101
00000011111100000001100100000010000101000000000000110101000000011111000100100000100001000000010010000
01000000000101010111111010010110001011100000000101001000000011000000000000100100000000101000100000101
00000101000010100000000100110000110110000001001000001001100010011000100011110000010000001100001000100
11010000111110101000011100110010000000110001100010100010000000000000100001010000000000010000100100000
10001010000001010001100010010001000010101110000000000001000001011000000100000001000000000000100001110
00100101000011010000000000100010101100000010011000111101000000111001100000010000010000010000010100100
10000001111010010000000101011011100110000100011000010000000100000000001111001000001110000110111011100
01010100101001100000000001000001010000000010000000011000000010000100000001010100100000010001000010000
00000100001000001010001011100000110000100001101000111101001001010000000000110100111101010000110110100
11000010000011000001001111100001110001010010000001110001110000100001001000100001011000100000000110111
01000111001110100000010000110000000101010000010000000000000001101000000100101001001111101000101010001
10010010000100010100000100100010101101001000100100011000000000000000110000001011011001000000000100110
00000000001000010110110000000011010000111100000011101000000001001101100001001000101101001011100100110
00000110100010000001100000000010000010000101000100000000000000011000000010110110001110110000100010001
11101011001000001000010100100000000010000000000110000000101010001100000000100000001000000000000100001
11000010001110000100000111001110000100100000001001001000000011000010010000101001000110001010000001001
00001010000001010100100001000110000001010100000110000000000110001100100000000011000101011010100111010
01110101010100001010000100111101000001000010101011100010100010000110000110000000000011000010110110000
00000000000100010010001000011100100110110010000000100110000001010000000000000110000011000011000010010
01000000000101001100000001010010000100010110101001001010000000000001000010000000000001001110010011000
00000000101010101001000011111100010010011110010011001100000000101100000000010000010011000001100001000
00001001001000000010000110001000011001000111010001110000101001110010000010001000110001010010000000010
10000010101010100000000000100000000100100001010000011000000110101111000000110010001010100001001011000
00001000111000000000001000100100000000000010010010101110001110100011001100000000010110011000000000000
11011100100000110000000011000000000001001010000000100100010000000010001001000001001000000101000100000
01010100001000001001111111010100001000100000000000000001000000001001000010100011100110000011010101010
11001000000010100000100011000000001010100000000100100000110010011000000111001000001000000000000001000
11000010000100001110000001011000100000000010000000001010100101110001000100011101100000101000100001001
00000100001100000000010011000000001001110001000100110100100100111010001011010001000001000100000000000
00100010000010010100010101001100010100000001001110010000100100010010001010001000100001100000001000010
00001010111000011101010111011011100000000010100000110000101100001000100100010100000100101111100000001
11001110100000100100001000000000010000001100010010000011010001001000001101010000010011000000110000001
00001010000001110100001000111110000010010100000010010000101000100000101010010000001011001100000101000
00000000000000000010100100111001110111000100010000101000010010000101110010100000011110000001000000100
01000011101010001001010010010001000100100100010010010100100000110001111000100000000000001000100010000
00000101010001110000100000001000101001010010001000110000100011000100000000001001010100011100001011000
10101000000100000101000111111011110010001111001000011001000100010100010000000010010001011010000001000
01110100001001001000110001010110011000110000010100001101000010101000100010001100110000000010000010010
00001001000000010100011100010001000001101010000100010010100101100001000000000001000101010000000010100
01000010001100001100001100001001011010100101010000000011010010000100001000010100100001000011000110010
00100000010010000111000000000100000000010000010000001100001000110100000000001000000010000001001101000
10000000000101111100001010000000011101000010000010100011010011101100011011011000100000010100100011001
00101000100100000001011101110010000010100111001101100000000010011010001110010000010000101010001000011
10000101001100010000001000011010000100100000100000000001000000010001000100010101111000101000000101111
00001000110010100010000001000100000101000000001010001011010100110101000001000000000100000011010100000
0000000100010000110100100000111000000011101101100S100101100100000010010010010000000110100010101110100
10000100100000001001000110000110100111001100100000000001000110010010011010100001000000001010100001000
01000100000000000110101100010101011100000000100001001100000010111010100100000000001010100000010110000
10101100100001111100010001000110010110110001101000000110000001001000000011000101100000001000001000110
01000010000000100000001100000000100000000010000010000000010110011100101111110010010011000001000010110
00000000000001001000001000001010000001000000001111010000000010000000011000000010100000001000101100100
10111100101000001000110001000101011101101100001000011011000111000010100010000000001000001100010000001
10000001000110010111110110000000111110011000011000010000011011001000000100000001000111011100011101010
10111001011011101100001000010011000100001111000101001010001100010000010000000011110000110101010000010
01100000000000011011011110000011101100000001001001100000101010010000000011000000010000110100010010100
00100000100011010100000011000100000000010000001000110110100001110100000001000011000011000100000000110
00100001000110001001011010100001001000001100000100100001111001000100001100011101001101000101000100010
11000111010100001000100010001000010010001000110001000000000101011000010100010000010001001001100101110
00010010000000000000000100010100100100110000001001101111001000010000100000001010100001001110001100000
00100010110000010000110001000000011001000000011100000000101001000000010101100100100000100000000010000
00010000011000001100101000000100101000000100000010010000100001100100100010100011000000100000000000011
00001000100010000001110001100000111100000000000101101000000100101100000010100000100100G00010110010000
01000000001001010100101001000110010000111011000100110010000001110000101100001100100001100010000011000
