00010110100110001101101110001000100001000010000101000000101000000011000000001110110100010100011000011
10000010001010000001000000000101000000001010000001011000000001010010101011100000110000001001100100000
00011000010011010000001011100000011010001010000011000010000010000010000011000000001001111010000010001
00101100000000000100010011000000011101101000001100000001000000001001000010010100010000100011010010000
00110001000011011001110001000000000100010010000001100010000000101101001001110000010011010100000100000
00100111001000100000000100001100010000001100001010000000100010000001101010000001101000100000001010110
00001010111010110010000000000000000101000100000001001000000111110010101100011101000111000100000000100
01110000001001010011101000000001000100000100100011110101100000111110010110100001110000010000001000100
00011001101001001000001101010001000010001000110000000000000000100100111010101000100010000011010001000
00110000001000000000110000010000001010001000000010001001000000110001100010101101100101010101000010000
01110010001011100000001011010101000100001000100100000001000000100000100100100010100001000010001010100
00010100100000000000011000110110010100110000110000010100011000000011011001000000010000000100001000100
01000100010101000000001100011000000100110110011111001110100010010100100001000000100100001000110100000
01100000001110000101100010000000100000100011100000000101111000010100011100001110001111001010000000000
10001101001100100100100100000110000101000110000000000101110110000101001000000001010011001001100110010
00000010100100001000010001000010000010010000100011001100000101000100100100100000100001101100010010010
00001100010100000001000100000000101000000011000111001010001001000010110000000000101001100011100010000
00000010010001011010000010110100100101100100100000010100100000000111100011111001000101100110001000011
01100000100101000100011111000010000100001000000100100001100000001101000000001100100000000000000001001
10101100001101000000101000010000100000011110101111000010001101000110000000000101000001000010011000000
11001000000111010000000000000000100000100001000010010110001001000000001000001000101001001110001000001
00010010000000011100111010000101000000000001001100000100100110110011001000011101010000001100011110010
10000000000000100011010000100110011110110010001000000010101100100100010100000010000100001000101001000
10000000100000000000011101010000110000001110001101010111001010010000000100000010010000001010010100010
10100101000000010110011000100101000000000010011100000000100010101000010110001010101000011110010100000
00111001001001100010100000010010001111010000010001010011000011100000010101010100010010000000000001001
01010011001100000010000000100010101100100000110110101011000000101000100000110000000010010101000001000
11001000100010000000110110010001100010111011000100011101000000100000101100000000010010000000100000000
00001100001110000010010011100010100110101000001111000000001001001110110000001000011010010001100100001
01000000100000010101101001000100000010001100011001010100100101000100000000001000001001000100010110000
00010011000010010100000011000010010110000010011101000000100001011000001100100010100000000011010000000
01111010100000100001100001000011100001001000010010001001000100000000000001111000000011000110000001110
00000010110000101000010011101000101011101011010000111000010111000100001011100101110000001101001101111
00010001100000010001101000001000000000001100000000101100000101100000010000000101000010001000000100100
10100110000011001001011000011000010010000001000011000001000010000000110110000011010000100100000010010
00000011111100001000000001000000010000000110100010000100001011101010011010100010110011001000000010101
00010010000100000001010100000010000000010000000010101001101010001101000101100101001001010100011100001
01000010111000001011011010011101001011100000001010000000000001010001010110110001011010000010000000010
00000011101100000000000000010000010001001010000000110000100000000000011101000000000000010000100001000
01011100100001001100000101000010101101100000000100100001001000001010101000000010000010000001010100101
00100000010101010000001100010010000010001001011001100000000110010010000010101001000011100010000000000
01100010000001000000000000101000001100011011000000000000000011000000000010000010010100001101011000000
00101100000100101100000100000000000010000010010000001100110001010100000010001110000001100010000000111
10010000101000000010001000011011001010110110001000101100011000000001011000101000000110010100000111011
00101100000001000000101000000111001000001001010001100100110001010000001000110100001010000111100010000
00000000010000110101000000101001010101000000110001010101100101010001101001100010000000101101000001000
10100000101100001110001000000110011011110000001111000000000001001110000000100100100011100100100010000
00100000000000000011000011010000100011011101000000111000000000000000110110000010000100000000111001000
00000001010010010010100101000100000110010001101111100100110100100001000100000011100100001100000001011
00000000001001100001011001000011001100000100000000000000100010001111010000111101000000010111000000011
10000101001110110000101100010101001000100000011100100000110010000011000000001000000100001100000110100
1001010010110000000000001011001110101S000100000000001010100000100100101110000011100000001001000100000
11111110001100000001000001000101011010011011100011001101001000000000011010011011000010100101010101000
00000110100100010000100010010000000000000000011100010101001101011000011000110100000110110110100100011
10101000011100100000000100001010000110100100000101001101000101110100101000000001010110000000101000000
01010000001000010010100001010001100111010001101010001000100101001010100010111000000001000010001101100
01000100010010000000000001000101100000100000101011000110100100000000001000101000100110001110000010100
00101001001001001111000010101100111001010100010001110110101000010001100101101010001000001000100001000
00011010000110101001001000000100000101001010001000000000101111010110100010100111000101100000000000011
11001101000000110000100100100100001011100000000001000111000000010000101110101001101000000101000010000
01010110101101110000011100011110001110001000000001100000000100100110010100100101101000001100001011100
10101010010010000000010101000101100011100000001101110100000101101000011110000000001000000001100000100
11110010110010000001001000110001100110111000010010010000100010000000000010100001000000000101010100011
11000000100000000110010101000100101011101000010100101101000001000010010000010001010001110110001000001
11100001000001001001000000000000100010011100000101001001001001001000000000010000000000000001000100010
10000010010000110000010000101110100000000100000000000101100011000010000010100101001001000111010100011
00001000001000000000000110000001010101000000100010010100001100111100001000000000000100000011001110000
10001000001000000011011001001000100010000101000000000100001100000101000001100110000011000110010001001
10000000000001000001101010101010100000110111100001000010101001110000101100100000000100010000010010001
00110100000001101000001001000011100100101010100010101100110011101000100010000000010000001011000001010
00001011000001001000011010100010010000001000000000010110110011000010100000000100000111000001001010100
00010001111101000111101101000000000000000101000000110000000100110000100000010100000100000000111101010
00101110001010111000000010001010101001010101010000010010000010011000110001010000100000011011011010001
01010001101100001011000001001001110010010100001000010000000001010010001100010110100110100100001000001
00011000010101000100001000100000000010011000110000000110111000001000110011000000001000001000001000000
01010110001000110000000001111010101000010001000100010000010000000011001111100000010000010000000111000
10010000101110110100000000101001000000000010001000001000000100001110000010000010100000010000000111010
00001101001000001000101000000000111101000000000110101000010000011000100010010101000001011011000010010
111011101010000101010000100010010100011011001001100010001G0010110010000110010000000000100000000010000
10100001011000011100000001000110010110100100000100000110100001100101101001001000001101000000001000011
00101010000001001100001010100001010100000100000111111110100001001010011010000000000011000110000000001
00010000000001110010011000000111001110000011000010000010100000000010001011001110000000100001010000000
10000001001100111000100000100000000001011111111100110000110100010101010010100000001010000110000000001
00000000001101111100100010001000010000001100100001110110111100010100001110001100101000000000000000100
00101100100001001011100000001010000000101110000000001100101000100101100110001100001000000000100000000
10001001000111001000100000001000000100100001000001000011000100100101001100010101011010010011000000000
11001011100000000010000000001110001100000000010010100100000000000000000001110000010010011000010100100
00000000000000000110000011100100000111100000001001100000100000001010110100101000100000100000000000000
00001000100001110010111100000010100100000010100001011001101000000110001100000100000000100000000101100
00110100010111010100000010000010000000010100000111011100000111001110000010100011000000001110110000000
10011010000000000000000000100001100100000000000000100000000101010011001100100000111110010100000000100
00010010001000010110000000011010110000110010010010010000000010011100101001010110011001100000100010100
00011110000001110011100000000000000000101100000000111001110001011001011000110010100100000000100010100
11100010011110100000010110000100100101001000001000010100101000011000000000001000100000000000001001001
10010001001010010000000000001011000000000001001100011100000010000100000010010010010100001100000110000
11000001001001010010000001000000000000001110001000000010010100000000011000011000001010001000100000011
01000100001010011000010010010101000000000001010100001110000010001010010010110110111010100110110000110
00100000100110100100000001000000010000011000001001000000000000010010001001110000010000111111110000100
10001100111000101101010000010010000000110100111010000100001000000010100000010100000110000100101000010
00101010000000011000100000010101001010100111001001010101000100000010101100000100000000011110000010000
00111011000100100001110100000000000010000101000011100000000110000010000011100001001100001000001000001
