00010000001001100001000100101000000100101000101010000000110101001001001000000110000001000100000100101
10000100010010011011001101001000011000000000100000111000100110001000000010000111001000111000000100100
00001010000000000000001110000000010000011010011000110000010100001001000000101100001000000000100011000
00110100010000010010001010100000100010000001100101000100011000000110101101101011001000100100000000010
00100001001100110000100000000000100001001000001101100001110000001100100100101001000001100010100011001
00000010000000000010001000000000111100110011010100001000000001000101010000000000001000001001010001000
00000010101001100000010100100000100010010000101000110001000101110110001000000001100010000000001101010
10000001001101000100000001000000100010011010010111010010000000100010010001000000000010111000001000011
01010011110100111000010000010000110010010100000011010000100101000000000000000100010100000001000001101
10001000000000010000000000110010001100011101010111111000100100000001010010101000010010000000000010000
01100100000010100011100000000100011001000000001110001110010000100010010001001011001000000111000000011
00001001010001001000000001110010010000010001100100010000001001000001000000000010000000100100101001000
01000011000001001101000000100000010100010000000100000000000110100000000010010000011000100000010100101
11000000000011000000001000110100110010100001011100100001001000001001001000000001001001000101110000001
10110100001010001010000001010011000100000000000110100101000110010010010000000110000100001110001000110
10011000000100000000001100010101000010001010010110100010100100010100100110100110100001011001110111010
10000000111000001000000110010000011100100000101100110001100101000010000000001110000000000000110101010
01011110000010001010000100001001100101000000010100011100100010000011000010010000100000100000100001001
01000010110101000100000100000000011001000100001010100000001010000110000011000000000000000010101000101
00100000001001000100000011111010011100010000000100000010101100100011100001000000000100010011100010010
11001011100010110011101100000000010010000100001100001100010101111001000011000100000000000100110101100
00011010000010001010011011001010010000011010000101110110010111000001000010100000101101100000011111010
00001100010010100100100000011000000000000010101010000000000110000100100100010100101001001100010010010
01100010001010001000000000001100101011011001000010010000000000000010001101000000010000010101000001000
10001000001000000000010000010000011100100000100001010110000110001001010001000000000000111100010100000
00010000000100001001000000001000111100101111000000000000000000000001010000100101001000001010100000001
10010110000001001011000010000101001100100000001110011000000110001000000000100101010000110101001000011
10101001000000010000000000000001100100100000100100110001100000000000000001110100001101100011000000000
00010101000000100000000100010101001000010111100000000100000001001011000000110000110100011010010000101
00001000001100000101001000100100100100000100110000010000010000100011011100010001000010000000000100000
00001000000100000010011101100000000000111101000010010101000000000011000000110011100001100011000110010
00000000010000000101110011100100100000000000100100010010000100000011000100110110010000110111110010110
00000000000010010000101000001000010001100001010100010010000110000010010000011010010110000000001000000
00101000001101100101000111100101001000000000001000011101000000000011000100000011101100100001001110111
00000000100110010000100101001010000101100001000000100100001000100010110010000000000010010000001000001
11010101000011110010001010001000001100011011110010000001000010000001001000000001000000010001100000000
01100000100000110000100011000000000100110010000110010000100011000010011001101100010100101100010010001
01000000100000100000000000000110000010000000101000001000000000000100001011000000000100100011101000101
10011010111001000000010000010001111001110111000001000001001100011000000000100010001111101110011011101
11000110111011111100101000100001000000111110011000100000010110000000000100110000010010010000000000000
11001100011001000011100000101000101000010000011100000100110000000101010111100000110000001000001010000
00100001110000100000000001100100001010010000000000011011001011001100100000011010110010011000110010000
00100000100001100010000111000000010100101100000010000100001110100100000000000010100010010001001100010
00000010010000000110110000101000010100101100100000110000011010100011010011110000000010010110010011100
00001010110100000111010101010000001101010101011010010110100000001010000000000011010000010010101110000
01010000001101000000000000110000011101010000000100001001101100001000000101110100001011000000000010001
11100010000011000000011110100000000000000010011000101000100010000100000011000100010000010001100000100
00010000001010101100001010111100000000000111000001000000000100000010000000101001000000010100000000000
00110010011011111000000000100000000011100010000010100100000000010011100000101010000001010100100011010
00000000010001100101000000000000001000001101010000100110100100010100000100100000101100001110000010001
00001000000100011001000000100001101000010000000100100110110000000010111011100010101000101000000000000
00100010101110000001100010000100110001100100010100001000110001001100101100001000000110000001000110010
11000000001110000110001100100100000000100000001000010100010100000000110100000000001000110010001010101
00001100000000000000101000100000001010001000000001111100101010001110010110000111000000000011010010000
10100101000100000011000011000000010001110010001000010000000000100110000000010110100000011000000011011
10011000000001010010011001101001111110001000000100100000011010000100001011000001001101000000001000010
11100110000000111010000100000101010000001010000100000000000100000101010000000000000001000001000100001
00001000011010000000110000110011000110001110000000010000100000000011000010000110100001010010101001100
01011000001100101010001001101100001010010101110110010010000010100111101011111011000100000100001000101
01000001100001110000000110000000001010001101010100010000111000000000100000000010001001001110000010100
00001010000000100001000000010000011101100010000000001100101001001000000011110000010010010000001001000
00100010010000100100000001100010001110100000001101000001100010101000110000110000100100111000100001001
10011010100000000100001000100000001011010000110100100100000101010100100001101000011001011111100010101
10010001010010000111000011101000000101001010111100101001100100001100011100100001011011000100000001110
10010100010000110011000000110011000001000010000011011000011110001001000000111100100001001000010000000
10011010010110000010001100001000010100000100100001000000111000001100000000010110001001001111001101000
00000010001000101011010010100101010000000000000100000000000000110101001010001010100110001110100001000
01100100100010000000100001011001101000100111000100000000000101000001000101011011010001001101010111100
01100110011000000100000001101001011101011000000000000000010010100001000001100000000000000001100100010
01001100010101010101100000110001010101000101100000010000000000000110101001000001001101001000010110001
11110010000110100000101000010011000000000010010000000101000000011000000001010000011011000011000000000
00110010101001001100000000000001011110001000000000110000101111000000110011000100000001000100000000011
00000110011000001000000001001000100010000100100111000110001000000000011100000100101100001000001101110
00000000000100000100000001000000000001011010010000111000000101010000101100000011000000101100001011000
10010001000101001000000001010001000000000000000000000110000000100010010000010100000000111100000000111
00010100000100001101010000000101011101000000001010110011001001101010000100100000000100000110011010010
01010010010000100110010000000110000000111011111101001000000011100000000001100100011100110100110010001
00001000000010001000010010000001000010010100010101100001011000100011101000000010000010010000010100010
00000111011000001110000001010011110000100000011000000010101000110101000010110000010000111000100000001
01000000100110101000000000000010010101000110000001001010011001011001000011000100000010001010101010010
10000100100010001000010100110100100010000001010010110100010000100110010111100000000101101100011001010
11010101110010100001000111101001100010000110000010000111001100011111001001101000101100000010100100000
10001001001010100011110011000000010011000101010001100000011010100000000011001101010001110111010010000
10000101010000110110000100001010100100010001011000100101111001100010100100100011001100101000000000000
01001010000100000000000100101010000000100101001001000011010100101001111101010000000100011000001000000
00010100000000010001110111011000010001010101000001010000100010001000001000000100110010101000000000011
00000000000000000011010000100100100101001000100001001001100101000000010000101100001011000001010010010
10001000000010101001110100010000000110000000100001001000000000110101000001001001001010110011000011100
00111100100010010010000000100000000100111000000000001100000010100000011000010011111101000100011000101
0001001010000001000100111010001G110010011000000000000001011001000000001000100000101000001001000011101
00010011111001011000101000011010101000000000100000110000100001000101010000100000100010010011000010010
01000000101010011100001000101000101100000010000000000100000100111100101000001100011011110100100001110
00011100100100001000100001000011000101000000110100010100110110001001000001010000010000000110000000010
00000111001000110100001000010001001001110100000001001000100100000000010100000010110001000000000000011
00111011000010000000010001000000010000010100010101011101000000010010001100000000110010000000100100011
00000000000000100110101010000000001010000000010000110110101100000110001000000001010000011100000101010
01000000010000000111001000000010100000S00000001100010011010110000100010000011010111110001100010000010
01000110010001000100110000000011000010100010111100001000001000010000000100001100000000001001001110100
10000010000011010100110010000100000001001000110100010100110101100100000000010100110010100111011000000
00000001000100000010010011001001101001001000000000000000000100100000000010001000000000010000000010111
00000001001001001010010001100100000010110000010011110000011101000000100000011001010101000000000001010
