10001010011010000101010010010000011010010010000000010000000100110000100011100100000110000110110110101
11100111001011010001000111000000110100101100110000000010001000000001001000001100001100010100100000010
00010001000000100001000000101100000001000000000010000000001011010000111100001000100000011101010100111
10100000000100010010000110000011000111001010111100001010001000100000101100100000001000110100000001000
10010000000000001001100010000000000000011101100010100001000100001000000010001001000000100010110100011
00000010000001001100010100100000100100000001000010001000001000001000000011100000110100100101100000001
10110011010110000100010100000010100010010010011000010000001000010000101100100110000101010100000001010
10010001100100100000100000000100000100101100110001001011100010001000010010010001001011001000000010000
00000100001000110110001000110011011000101000000111000101001111001000000000001011010000101000000000000
00011000000010000001101000000011100000000000000010011001000010100000000101000000101001100000000001101
00001000000100110100011101010000010000000001000100110110010000000001010010100110100000001000001100001
00100001111000001101110011100000110010101100011101101000010001011000101000010000001110010010001101100
10101000100010000010010000000000000111100101001010000000000001000000000000010000000010000001000011000
00101110000110000000000000010000100100100000010011001110011000100010010000101010100100011000100010010
00101001100100001011100000000010100000110000000100001010000010000000001111010000010001000110110000010
100011001000101000100001100S0000000010001100010100001001000000000101001000100100001001010101100110001
01100010110010010000101000001000000010000110100101000000010010001001001110000000000001001011001101001
10100001001000000000000011001111100001011001010010001100000111000100000000100000100011111101110100000
00101001011000001000000101000010010111101001010001000000100101010000000000101110110010000000001001000
01001001100000100000001001001000000000000100100000000000000110000101000000100000001000000000001000001
00000101110101000010000000010101001110101101001100000011011011100000001100101000011000000000010000001
00100000000001000000001011010101001111101010000000001010000000110110101011100000000000011000110000110
10000000010000000010011101100000000100100000000100010101010101000001110000000100101100101110000010101
00001000010000100010000101011000100100010100010100110010011000001111110001000000000101000011000010110
10011000000110000000010101001110000000010000000101111001100110100000000000100000001001000110000100000
00101100001000100110111001101001100000010000100010010001011000010100000010000111000110000001001100000
10000100000101011100000000001100011000000011101000000011010100001100100000101110000001010101010100000
00000000100001000100101100000010001110110000001100000010001100000000110000101001100110000100100000000
00000100000000001110010110000001100000011010000000001000100001010011000100010000100001011000000100110
11000000000010000000000000101001010000011001000010000100000000101001000110010001001000000000101100011
00011000000010010000000100011000001100100001100110101100000000100000000100000011010110000100110001001
10010000101001100000000010100000000000100000110011001001011100001000000010101100110000000010000110000
00000101100100111101001010000011000101000100011100001010010000010110000100100010010011111100010000011
00111000010000101100000101001110001111000010100000011001001001010000000000010101000010100000001000000
11010011010010110000001000100010001000000000010110010000010010001001000000101010101101111010011000010
00010001110000011111000100001000010001000011001000001000000000000000010000010101001110100010010100000
01000011100000010000101001000011000010100100001000110000000011010000010011011000011101100110001010000
01000101010010010000000100000100110011000100000011010000000000000010100001101100000000010100100000000
01000011100001101010000000001000101100001000101110010001000000000000001000010010010110100110000011100
00001001000001000001000001010000000001010000001100000010110101110011001000100001010000000010110000001
10100110000001000100000000100111000101010000100001011000011100011001010001110011001000000000010001000
00110000001110010010000000000000000000000100000000010100100001000000000111000000010100000100000000010
01100001000101010110001001001100001100000101000010001000111110101110001100110100000110100000010001101
01000100100101100000010001100000101001001011010000010100010111010001000000001001110100000010000000000
00010001100000010000000010101100000100000110000100100010000001000000101010010001100000100100010010110
00000010010100101100000110100000101010001000100100010100000000000100010000010010010000001010000010010
00010001000001100110000000001001100010001000110000001101101000101101000000100001101000001010010000011
00100110001101001001011010100100010011100000100000010101100001100010000100000000010100100101011010000
01100010000100000101010101000001010100100000011100010000000100000101010101000001100101011010110111001
01111001001000000010000000101000010000000000000011000100010000011000000000000000010000001000100100001
11010000011001100100100100000000011001100100101001010000001000010010001011100000000000101001100010010
00011011001100111110000100010000011000000111000100001100110011100000010010000001000101000000000001000
10000100000100000101000000110100000101001000011000001000000000100100010000001000101110100001100110010
00100000000000000011010000000000100000101010011100100101111010000001100010010010101010101100000000010
00100110100001110110000000110001000100000001010010110000000111000111000000000000010100010010100001000
10010000000001000010000000001000000100010000000100000010010100101100010000100001111001000010000000100
10000000110010001110100110010000001000000001001000000010001100001100000101000001010000010000000011000
01010110011001100110000000000101000010001001000100001110000010000100101000000000000000011000000100110
00100001010000100101100110000000110010000010001011000001101000000100000001110000001001000000110010110
00000011101010000010000001000000000000000010010100010001000010000000001000110000001010001011100101001
01000000000001100001100100010000010010100110100001010010000001000000000011000100000110100000000010100
00001001000010001010000010001000101001010011000101001001100000001100100110000011000100010001001000000
00000000000101101000010100100101100101100000000110101000000011001010010000111000000100000000100101100
00001000100001100010001110011101111000000010111111000000000110011000000101011100000101101010100000011
00001000101010000000010000000000010110100100010010001110110010001000010000000101000100001011000001010
01000101000000010010000110001001010000110010001010000000000100010010001110000000001100100000011000000
00110111100110010001101100010000000001001000110000000100000001010110010100000100011100000010101010100
00001000000001100001000010100011000000000000010000100100100000010010101000011001010000000101000110100
00001010010101000010000001011010100100001000001000101000000111100000001110111000010000000110000000000
01001000100100000001000110000000010000000010000010000000010001010001110000100000000011100001000000010
00000000100000100000011001101100110000000001100100100000111001000000000010000011100100100101000000000
10101000101000111000000001100000101000000100010010000010000000100001100110100001011001010100100100001
01010000011000000000011001100100001011111001001011000100000011001001010010010100001101011100101001010
00001010000101000010000001000110001000100001000010001000000000010001010011010000001111100100100000100
00001010111101101000000010100000011000000000000100000000001101000000001000110001001010111100001001000
01000001000000100100001101010000000101011000001100000011100100111100010000100100000011101000100110000
00010111001110000000010100001100100001010110000100001010010101000011101000000010001001100000000111100
00000000100011001000100100101010010000001010100000001000111001001000101111000000100000111100010000010
0110000001101111000000100100000010111010100100000100100100G000000000000010000001000001100001000011000
01101100001101000001000110000001100000101101000100000001110000110010000110000100010010000000000100000
00101000100000010000110100010001000011001100100000010001001000010000111100010000100001001100110100000
01000000010001000000010100000010000001100000000000001110010000100001100010101000000001010000001010000
00010000000000000000011000001100000011110101010100010010000010000001000010001001001001000011111000011
01011000010000101010101100001110001000001010001100010000000110001000010010100101000001100011000110000
10000011000010100010000000100010011000000100100000011110000000100100101100000000001000100010000110000
00000001011001010100100100000000100001000010011111000010010000001001010100100001000000000101010000110
10000010100010010000010100000000010000100011010100000100010100000100000100000101000001000000100100100
10000001101000010010000000000001101000001100010110011000011000001000000101100101000110001000001110001
01000010000010010001100000000001000000001101010001000101000000010001000000010100001000000010010000010
10100001101000001001010001000100000101010011000110101101001001000010001000000110000101000000010110000
10100110110010110000001001000100011010001000010011000001000000111000000110101100000000000100100000100
10111000000000100000100111111010111100000000110110101000010000100001010110000001001001011100000011101
00001100000000001001010100010110001000010000000001100000110100001001001000010000000100011000110110010
10101000000000000011011011110000111000001000100000100000110100101111000001000000000100110000000010010
00111000000000101010100000011001001001000001110000010000001001100001000000101000110000010011001010100
00100100010000000000110101000110010000101001001000000010011001001000100000001001101000000010001010101
01101010000001000001000000100011000011000001100010011000001000000100011000110100000010000000000000100
10011101110000000000000000011010000000001000001010101001001100000000000100001110000010000001110101001
01100000100001000010110011011000010001000100101001001100110000010010111010000011001110110000101000000
00001100100101010001000000000000100000000100000010000010010000010011011011110101001100100100010100000
00000100000110110100001001000010010000011000000000010110110100001100001010001110011001101010001001011
