00101100001000001100000000010010100001001000000101000000000100000110000000000000111000000001111001000
00001110001000100100010001100100000000100011100101011000100111110001001000111000110001000001101111010
00100011110100000111101001000100101010100000100100001011100001010001000101010000101011110011000010001
10000100011101100101000101000000010000000010000001000100000001000000100001010010100010000000100010001
01010000001100010010000110100000000011001000010000110000001101100100000010000010101001000100100100001
01000100100100100110001110010000100101100000000000010101101100000000100000001100000001000010010000100
11001000000000010011001010111001000011100110000100011011101010100010100000011111001100100001010010000
10000100110001101000110000000001100111000000010010100001000011100101010000011011000101100001000010000
01100001010100100010000000000000001111000010000001001000000000011000100011000011001100010010000100110
11100100001001001000010000100010011011100100000000001000100000010001001100000000001010010101001001010
00001101001000000001010000010000110000011000001100000001000000111110010101111111100001101101110000000
01001100100001101101000100000000010001010010001010100000000010000000000110001100000010000100010001010
00010010110000010100001010000010111010000000000000101100000111010010100010000100001000100000110011001
01000000100000010010000000011111100010010111010010011100010000001000100110010010100001000001000101000
00000000000101000110110011000100000001111010110101000010000100001010010000100000000000000100010100000
00000001100000000000111000000000000011010001010010000010101101000100000101001000000001010101100000001
00000101110100000100100000011110110001000100010100000010000100000010000100000000000000010000000010000
00010000110001001010100000000001000001001010100000010010010000011000100101111110000001011000001000100
11000100100100000110000000110000110000001101011000111010100100010010010110100101010010101110001110110
10001001001111110100000010010000000100001101010000000000000111010101000000000000110011000001000011000
00000100100000100000100000010100010000000000001001001110000010001100110000000000110000000100000001001
00001000100111001000101100000010110101000010000000000001000110000000000010000100010010100100000000000
00000001011000100010000110010100000001000100111111000000000010010111000010110110100110001010110010100
10111111100100000000101100011100010000000100010000001101000000000001001001100000001100100001100001010
11100010000010001010000000110001101000001000001100010010110010011000001001000001101000000100000010100
01100010000001011100010011101010101001010000100000100100000110001001010000010101110100000101110001001
11001011100000010000100110100000010101000101001100100000110010000000010100010010000001101001001000001
11001000001000000000101000011101010010000100000100000000001000010010010010100010000000001000000100000
00000101010000000000000100011000000100001101000101100000000100100011110100000000001001010010000001111
00000000001100101100010000010111011100010111000000100010010101000001000010100100100010110100000110101
10000001100001010010010100001100000000000111000101001001111100000000110101001000000010010010011000111
10100100000001000010000010001001010111101010011110001100000111010101000010010101011001000001001001000
00001100001010000000100110110000101000010000000110000110000110110100110000110010100000001110100100000
01010100001100000000100001000001000000110001011000010110001010111010010000001000000000111000110111111
00101001000000101011000000000011100100000100001100001000111000010000000010000001100110000000100001000
00000110110001010010100000101000001001010000100001100001010000001010110011100110100000000000000000101
01000000100000000010000001001000111010000001101000000000101001001000011000000010010000000010000100110
00011000001000000001110000000010000001001001001100000100010101010001101110001011000001101001000000000
00000000010001010010000000100000000111100100000101000101001000000000101000000110100100001010100110100
00000110000000000101101000100100001000011111110000001000011000010100110010000011000111010100100010000
01100100001000000001000000000101001100100100100010000111110101010010010101001000010000000010111010111
11110011101000000100100000000011000001000100001000010111101101000000010100010111111000010011000000101
11110001100010010100000001000101110001001010011000111110001100100000101000000100000000011001100000000
11110000000010101010000110110100100000010010000100000100110000100001001010111011000000001110011001000
00001110001001000110110010110000100000001101101000100001000100000010000000010000001000000001010110111
10001000000000000101010000000000110110011000000000000000100000001001000011010010001111100000000011110
10010001011000101100110010000000100000110110000000000101000011010000110101000010000111000000000100010
00010000101101000111001000000101010110000001010000010000000111100000110010011100100000010000000011101
11100100000001011010110101001100010010010001110011000000110010100000000100110010100010100010100000000
00000110000000000001110110010101110101000000001000000100001111000000000000101010010000000000000111100
01001101100100100000001001000101000110110011110010001100000011001010110000011000000000100101000101110
11000000000111000000000100000000001100100000000000001101101000100101011001010100110000010000000000000
00000001001011000101000010010011011010000100100100101100110000011000001100001000001011001000000001100
00000101000000101000010010000010001001110000010010000001010000110001010100001100000000001001001000010
00000100100000000101001100001001000010000100000100010100000000001011000001001100100000100100000010100
11000100111000000101000010100011011100100010000110101111001000000100110000110100000010000101010110110
01010111010000110100100000000010000000010110010100000000010101000100100000000010000100000010010101000
01010000000100010000010001000000100110010110000001100000101101101001100000001100100001110100011001001
01001010100000001000100000100000001001100101001010101111000000010100001011100000100001011010000011001
01010100000010010000000001000100001001100001010000001100000001001100000001100000010010001011000010100
10000101000000000011100101000110010001000010000000100000010010000000011100101000101000110101011100010
00010001001000110110101110011100000110100000000000100001010000100001000000000000000100100100000011001
00101110111001000100000011000000000000000001111000001000000010011110000100010010110000000010000000110
00101000001000000000001001110000000011000000000010010100100100001111101111010011100101111000100100000
00010000011001000010000101001100110000001010100100000000000000100000100101000011100001000010000010000
00001001011000000000010000101110100000000001000011000000101001010011010010000000000000100001001000010
00010010000010000001000000000111001010100100000100000000100010010100011001000100000101111000001001100
00010100100001011000000000110100G00110100000000010001100000000001110100000000001101011100010100010000
00001001100100010001000101010011010010010000010101010101110111100000000010111000000010001000010100001
00000100001100100100000110000011010000000100101111010010000001110111100001000001001110101000001101100
00000010010000010000100001100000000001100110000010100000001000000011010001001001010010111100100000111
10000000001011000001011010101100000100111101011010000100101100010100000010000000011001110010000000001
01000000110000000100001100000100010000001000000001001010000101010110010110100000101110110110000001110
00000000000000010001000000010000000010000000000010000000010010110000000101000001001000010010110000000
01110010101001001010000100000000011001001000010000100000100001010010000000010010011000000111010100010
10011010101111001000100000010000101000000100000010100000000000100000001100000000100100110001000000000
01001000000000110100000000100010001000111100011000110010000000100101111000000000001001001000000010100
11011100010010011011001000000100110000100000000010010100101000110100110011000100010000001100110000010
00000000011010000000000100001000010000000111010000100000000000001101000000011000100101010000101110010
11000101000010000000000101000100000000000000001010000010100100101001000000100000110001100000000000010
10011100111011001000100000010000001000110100000001010000101000001010000001110100000000101000101110010
10001000010000010010000000000001010001000000010010001000000101110010000011000101010100011001000010000
00010111000000011000000100000011000000010101000001000010001000000001001101000111101110001000000000101
00011001000000100100000101001110000011010001110001101010001010000010101010000100110111100000100001100
01000100000100010000000000100100000101001010000100000010100001110010100001001000011001000101100101000
10100100000000010011110000101110001101010001100011010100000110100101100001000000101010001011000100100
01000100000101100000100000100000000010111110001100000101000010010000001000001000001010100010000001001
00111010000000000001111001000101000000000000010100100101001001110000100110111001010010000100011101000
00010101001001001100010000000000001011010011000010000000000110001000001010000000100100111011100111100
00000001111000001010000001001010010111001001000100001001001011000000100000001000000000000000100000001
01000011000001010110100100001001010100010010000110010001010000000010100100000000001110000000001100100
01100001100000101001010000001100001101001000011010100001111101000001000000011101000100101000000010010
00001111111000000101100100010100101000011110000100111110010011010000000000000101010001000101010000010
00100100010010010001000000000000000000011001001100000100100010000011010000000110010110100000000000001
1100010000S010011001010001000000000100000010001000010000010000100000001110010000000000001011001101000
01000010011011000000000011000000111000010010000011000000000100001000000100000000001000100000010111010
10101000001001000000101011010111000101001001000010100101000000000000000010110000001001100101000100000
00000001001101000011000011100010100000100000000101000000001000110001000100001100101000011100100010000
00000101000000101001000000000000001101101011000001100100101111100100110001011000010011001000100001111
00001000100000000011000110001001010000100010000010001001100000101101000000000110110101011000010000100
00000000000001110000100000110000000101100011000100001100000101101000100010000000001001101000011000000
