01100000101100000000001001000100100110111010100000101100100011100000000101000100000001001100111010001
01000100100101010000000000101101000000000110100101100000000001110101010000000011001010000101001110001
00111000000010001001010000000100100010001100000010011110010100001100010000101000100001000011001100010
00000101010000111100101001100110000111000010000000100000000011001000001100001100100000001000001101011
01010011001000000000000010001000001000001000000011100010000000000001010001010000101010000110010100000
01000000011110100110000001001010101000000100010001010100011001000000000100000000010000111000011001000
00000010000010000011001000001010101000101100000010000001110100000001010100001100000000101000000001010
00000110101010100001000001100000010001010000000000010011010000001001000000101000100000010001010010001
10000010000111010101000100000111000111000100001001001001000100000011011101010000000100010000100000000
01100010000000000011010100001100000100010001100000000101010000100110110010000001100100100010000000101
10011000100100110010011111011101001000010000001001001100000000010000010010000001110001001001101010000
00000010100000100010101000000111100000001010010000010000010000001101010100000010010000000000000001000
01000000000000001111110010000000100000100100000101000000001100001001010000011000000001010100100000000
10100011010001000000100010100000100000110000010010001000000000000001011000001000110000100110110001001
10000100100000100011000000011010010101100111000110010000101110100011000100000001001000100000000010010
00010010111000001110101000011000100100110000001000010001100101000100001000100001101010000011100001100
00000000000001001100100000011000010100101000000000010111010111010000010000000100000010001000000101100
00010000010011000110101000000001000100010010000000100010100000111010010100000000100001000011000100000
00000010101100000001010100101010101000000000000000001010011000101000010001011000001010100010010000000
00000000010001100111101010000000010110100000010010011011000000000001100100101101010111000010010111000
01000100000001010010010100000001001110101000000100110000011001010000000010000100000000101010010111000
10100000000101000000011001000000101000010000000001100001100001000000000000001010001000000101001001100
01100000000000100000000000000011110010000100000000010000000000000001000001001000000000001001100000011
00000001000100000000100100000110010101000001000000010100000000111011011000001000100010111000010001000
00011001100000100010000100110001000111101001000010000000000010101100101001001001000000010010010001000
00000100001010011000101100000100100000110010111000010000000100000100010010000101010000000001000001001
01000000001010010100001110100000100100100100000000000010100011001000111010000101100001000100110010100
00110000000000010110001010000000000000100011000001010010101001010100010010010010000011011000010001000
10000110100110010000100001010000001110011000101110100000000100000000001000100000110000100010000011011
10100000100001010000110010011010000000011011001000111010010001010000001000010110000010000001000000100
00100110110001010000001000000010100011001001011010010111000000011000000010000010100100000000010100111
10010001000111010110000111000000110001000010000000110010001111100111001000110101000000010010000110000
00110000000001000010000000000010000111000001000001001000000011001110000000010001000000101000001001100
10010010000010011110001110100010000000000001000001000001000000000001000000100001100110010011100100100
11001000000001001010110000000000001000001010001100010010100110001010001110100100010000100101000101010
00000010010000100000000000110000011000000010000100000010001100100000000011100110000000010101000001111
00000010010110100000000110000110000111000000011010101000000010000000010001100100000000100100000100110
11011001000000000010100010010000100010000010000011010100100100010001000000010110100111010000010000000
00110100000010000000110000010010010100010011010110000000010000001001000010000000011111001001100011000
01000000100000100001000000010010010110010001000000100000000001010110101000000000010000000101010101010
00100011010000000000000010000000000011000000001000001000001110001001000100S10000000001101000000100110
01000100110110001010000010000100100000100000000101101001010000000010100010000000001000000010100010001
01101000110010000100100001001010001010010100110000000100000110110001010001000000100101000010000001010
00010111001101010000010001011000100101001011010000001010000100101010100100001000010110101000010101100
01110010011011000000000010010000000001010001001000010100000000100000101101000000000000000100011000000
11110001001000010101001001001000101000010011100111110000001010000001000001010000100010011011111000000
00000010001100010110101101000100010000000000101011101000010000100101000000101110001110010000000001100
00011000000100010001000000000000000011001000000100000010001010001010000110111010110001000011110010010
01101010001000111000101010100001000111000000000000100000011010110011010101011001100000001000101010100
00000100000100111000000100010010110001010000000100000111001000100000000000110100001011010101000000110
00000000101100010010110110000100100011111000000011010000000010001000001011000010011011000111000100001
00110001000010010011101001001000010000001011000000011010001000101100000110101100000000111001100001000
00110010000000001000000100000011110000011100101110000001010000000110001010110000000010000111000011110
00101000001110001011010000100111110001000010100000011000101011010010000000001101111010001100100100011
01110010001011001000000110010001011001101001001101101110001000100000101110000000000000100000000011000
01000011100001101000110111111100010001001100000100000010011000001010100110010010100000001111000000100
00000100100000000010000010100010000010101100000000010100010G00000100010100010101001000110100010100000
00001000000000010011001000100000000001011001001100000000100101000110111010000010111001100100000010101
00001010000100000110000000001000111110000010100101011000000001010010000000101010000100100100000001000
00010100001000000001011101010101000010000100010100001101001010001010000100010001011001000001011110001
11000001001000010000010100100000000000001000010101100111001001000011101000000000000001011000001000101
01001110000100000101010001101010001110010100000100100010111000011000100110000101010000000010011001010
01000101001100001000010001000011000000100010001100000000101000100010100000011100000101100110010000100
00000000100001001110000110000010100101000100001111001010110100000000000101100000000100011100000000101
00001000000000010100010001001111111000010100010011100001000000000000100000110100110001010000001000001
11001001001001100001100010010000101010000001000000010010010000000100100001010000010000001000000000100
00001010001101000010100110000010010111000000001000000010001000000101001000101001000000111001001000010
10001000110000001100101010010001000011000010000000000100000001000000000110010101000000001000000100001
00000110010000001001000010000001001100000101000001101000100101000100000110100110101100011010001100001
00001000100001000101000010000010100010011001110000001100010100001100001100000000011001111000000000100
00000100100110000010100100000001001000001000010111101101011000100000100010000010010100001110000100101
01000100001110010001001011011000111001000001000100010110110001010000000101000000010000100101011110101
10000000000101000000010000010010000000101100000000000010100000010100000101010000100000001100010001001
00011000001001100001000010100010000100000010001001000010001001011000100001011100100010000100001011001
01101001010100000000000110000000101011001000001000001000000100010010000110000101101110000000001001000
00100000001001100100010100010100000000000100001100001010001100000000010100000110011100110001100011000
00011000100011000000000000101111110000010010010101000000000000000001001100001100000101000101101000101
00100000101001000100000000010100001001001000010001100101101100110100101010100110000110000010000000000
10100100000000011001000010000100010111000010000000000011000000000100000000001000000000000100101001000
00000000100100000100100000100000000000000100000001000000101010001100100000001000000000011000101110001
11000000100111000100000010001000001001000010101101000110001001000100001001000110001100000000001010000
01101100100100001000000000100010100000001001000001001000000101000010101001000100000100000000100001000
01010001001000101001010100000000001000100000100001000001000101100010000001011100000101000000001000010
00011101000001110000000010001101000010000000100010010000000010100000100100010010010100010000001001001
10110111000100000110111100100111100011001000000000001000111100000110010000100110001101101100000001011
00100000010000110001000101000010100100000010010000010000000100000110100000011011010001101100000000100
11110110000001100101001010000001000000010011111000000000100100000001000010010000001001000100110001100
10100000010110000100010000000001001000010000000100001001000000000001100000001000001100011000000000011
00001001100000000000001000110101001111100011000001010011110000010100000110010000100110000000110100001
10111101110000001001001001000000001000000010001010000100010000101000000011110010000010011000110000111
10100001110101001010000011000000110010000000110000010000010010000001011000000010000101000000000011110
00000001000100001101101110000000000011000001110001001010110100010000010101101011000010010000101011010
01001100001111100100100011010010010011001001000011100000010000011010000011010110000010010000010001010
10110100011111100001010101001000000000001001001010000000111001000100000110000110000001000000100000100
01110011000001110000100101101001000011000000111001110110000000011000101001000111001110011110000000001
00010010000000000100100000001000000111001100000001011000000000000000001010000100101000001100000000001
01000010000101010001100111100000000000100001011000100011100010010100000000101000000001001110000000001
01001001000001000010100011011001000000010110000010011010001001111000001010010000000000000100010100101
01100100000000010100000000001001100000000000010010011110001010110000000100010000001010000001110000111
00101011001101000000001100001100000001000011000000000100000001001001101000000110011011010000100000000
00000011000000100011000011110010000011011010000011000101110010111000001000111010000000100101000000100
