00001000000100000001100100000000000000101001000000000000001000000001100001110000000000010001000001010
00001110000110000001010101100001100100000001000001000001000000001001100001000011100000000110111010101
00001000100100101001000000011000100000000010000000011010010000000100001100000100110100100001100000100
10011010010010010100010010000000100010100010000000010110010000010101011111000010001000000000010010011
00100000010000011000000110000110000000100000110001110100000000101000000001101100000010100100101010000
01111000110001110000001111101000001000011001000010110100101000010001100001000100100100010000100110100
00000100000101001000000010000100101110000000000001000001010001100010001101011010000101000001101100100
00001010001111011011001010110100000000010000000000110010000101000110000001010010000001100001001001010
01000000010001000001100010100000010000010011010010000111001101001001010011100000000011010000010000000
01000001000011000100110010000000000010000000000111001001010100010110001100000010000000000000100101001
00001000001100110100101101100101001000001000110010000110010100000011000000100100001100100010000000100
00000001000000001010100100000001100100001011110101000010000000001010000010000000000000100001010000011
10010000001010000001100000010000011000001010010000001000000100100001100100100011000011010100101001011
00011000001000100001100100100000010000000010000001011000101010000101100101000100110000001000010000000
00000101001100001010100010000001001001001000011001000100000100011101110010000001001000011101000110000
00000010000000000000000000000010001100000010000001100001000000110010010010000100111000000000101010000
00001110001111000000000000011101101010101000101001001100001001100001010001000010100000100001110001010
00001001001101001011001000101100000001011111100100001100000100010111000001000010001110101010000110100
0000000010010100101000000110011100110101100000101000S110100001000010011000100000100010000011000001010
00001000000100010000001111011101000101110111000000100101000001100010001000101011000101011000000011100
10100000110001000000000000000100000111100001001010011100001010000100000010100000111001000011100010001
00000011000111001101010011100011000100111000001000000000000000100101001100010100010010000000011000000
00101100000100000000000000000010110000100000000010100101100001000010010010000000000000010000101001000
00000011011001010011000001011010001001001000100000010000100101101011001011000101001110000010100000001
00010100010001010100110010001001100001000000110011000000010011000101000000000001000000001110010001110
01000000001010110001000011000110000110100000010001010000000001010100110100000100001110100010001000100
00010000101100000010001101000011100000000000001010001000100011001110000000010000000001001100100011010
10000000011011001101001100011010000110000101011100000111011000110100010000110110000000100000000101000
01000000100110111000000000010111010000000000000100000000010010001000001000000001101010010001111000010
00010000100000000110000011010100100100100100001000101010000110000001000001001100000000110001001110001
11011101010000001101010000001000000010010100000000100000000000110111010110100000011000010000000001110
00010111000001000010100010001000000100010100001000110001100000101110100000001000100000100100000000001
10000000001011100100010001000010110111000010000100101111001100000000011010100000001000000110000001101
10001100010100001000000100110011110010100100010101100000010010100101011110000101100000010010001000101
10011000101000010000011000100101001000110010110010000000011001100000000000000010000011010100010010000
00010000100001000110100001010001000001110000010110010000010100001001011000100000100001000000010001000
01000100011010010000000110100000010010100000110100011100000100000001000100000110000000110000001000111
00010101000000000110111000011111010000101001000000000000100010011000100100010001000011000000001100101
11000010110011011101000110100101000011001100000100001010000000000001000010000000110101010000100000001
00101101000000001000100110000111001100100001000000110111100110100000000011010110101100100100001100000
10000000000100000000100000001000101010000001000001100101100000001010110100000001000000100000001000000
10000001010011110100001110101000000010000000101000000001010010011010000000100010001000100010001000000
01000000011011100000000011111000010100011001001010001010001000000010010000000010000000001010010110000
10000001010010000110111000100100000111000001000001101001100101000110000001011110001001000000101010000
11000011111110000010011000111100001000000110100001000110100000000010000000010000010010000000000011111
11010100110000000010001000101111101000001010001010101000000001010010011001000011001000000000011010000
00000001011101001100111101000011000011000000000010011010010000100001010000010100110111000001000101000
00001010000001000101100110011011000111111011001000000100001110000010111101011110101001000000011000000
01011000000100010100011100000000001001001100010000000001101000001001100010000110100001010110000011010
00000101001000001110101101110100001000110010101001000011000001000110000010000000000000001001000001110
00110101100100101000010010000000000100010000000101000100001100111100001011000011010111001000000000001
10000001000011111101110000001100010010011000100000010010011110100000100000100000100001001110011001011
00010000010001000101000000011110010101001001000011000011000100001101000100000000000010000010010101000
01010110100000011101100001010100001010110110011010010000000010001110111001000001001111100110100011011
00100100111010000100100010001000001001000000000101000100010011000000110001010100000100010110110000000
10100101000101000111010110110011000000000100011000010011011000101001001000111001010101100000000001110
10010110001001101000000000010010001000000010000110010001110111010000100000100000001001000000101111001
00000100000000000000010011101010001110100000000000100000001000000010010100010000000000000000000000010
00000000100000000000101010000001000100100001100001000000000100101100100000001000010000001000000100011
01111000100111000000101001001001000110001000000000000010001011000000100010000010001000010000110100100
11010001110000000000111111100000010000000010000101100011100000000110101100101001001000000100001100000
10110001000001000000000001101010011100001010000100000000000000000000110000101110000000000000010000100
00000100011110000000011100011010000111000001000010100111001000100010001010100011100011011010000011000
00000001100110000000000100000010010100001000101010001010101000111001000100000010110001001000000010001
00010000100100001010001000010001010001010001000101000100010010000100001101010000000010010000100010100
00010000001001001001000001000101000000010001001000010000011010001000110111101110001000000011110100101
00001001001100100000011001000110100100001100100001000001010000000001000000001011000101000000010001010
11010010010000100111000010000000100101001001001000001001010000010011011010000000010100101001001101100
00001010010000001110100001010001010101000110000101001000100010000000000110100010011101001101100100000
00000000100011001000010010010000000111110010011000100001001110010000010100010001100000001011000000100
01001100000100100100010000100001010001100001100101000011100100100011000000000110001000010100000010001
00000000001001110110000000000100000000000011110000000000000000000000010100100000010001000000000000010
10101000000011010001000001000010101010001101100000010000101000000100100111100010110001000010000110000
01010110100000001000000000000011000001011110010010001011101001100101001000110010010101100001011000000
00001101010011101000001001001001001100000101000100100000010110111011111010100011110110000000000100000
00110000100010000110000101000010011001100111100100010110000010110100000100001000011001100010011010100
00001011000101011001000000000001000000000000000100100100001001001001100000010010001000101001001000100
11100110000010101001001000000001000000100000101010100000000011000001000000100000101010001000000000100
00000000010111100000000000110010001000010000000010001000000000010011110000000111111000110000000010000
0110001100000010000000100001G001010000011100100010100000100010000001001000010101101000010010111110000
00000010100000011011110000001100000001000000000011101000110000000000001001000000000100000001000101110
00001000100101100010110000100111110100000101110000000111100110110000000000011101010100010000000001110
11000000111011001010000000111100000010000010100110110010001011001101001010000100000000001000010000000
00000110000000100100000000000100100101111000000010101100100000000000001000010101001100100001010111101
00100010000111100001000110101010000001101110100000001000101010100000010001000111000000011000000000000
00100000100101101001001010110100011000100001000001000000111000101000000110100000001100000001011110000
00000000111000000000001000011001001101100000000100000010110100000100101101001010000010000001000110011
00010000001000101010010100110011000000011001101110010110010000001000101111001010011000001000000010100
01000110000010000110110000001010000100000100110100000001010000101001000011000010000100110001100100001
00100000011001000101100101100100100010000001001111011000000011101010000101000000010000000011000101001
10000010000010000000000011110000000011001011010100111010100100000111100000001000010000011010001000000
10000001000100001000000110000001100011010100000100000100000001001000000100010010001001010011010000000
10010101000100110000000010000010000011101000000000000010101000100100010000000000000000100000001101000
01001000000010010001000011000000011011000010111000000101010000101001000001110010010101010001100110100
01001010000010000001110100010010111001010011000000100000100000000000110010010001000101111000010000000
10011001101000000001001000000000000110110101000000110101010011100000100000000101100111000101100001000
00000000010000001001001101001000010000110101011010001101100000111111001101000100000111100100110100000
00000000010000111100101101000000000110100011101101100000010000001100001001001101000000101001001001000
10011000101000010010110011011010101000010000000000000000000100010010001100000100000010000000011000000
00001100100000101000010011000100000000100010100000011110000010010100101010000001100000100100100111000
10010000010001001000010010001100000101011000000101000001001000100001000000100000000000000000000011001
