00000100100011010001001010000000001010100001000111001010101010010100010000000010000101000001000101011
00000001011010011001100010000001101000110001000001000111010010010001000000010000101001000000001100000
10100010001000101000001110010101000010000100011001011001000001000000101100010010001000010000000010000
01000000000001111011010001100010010011000000100100010100010001001000001110101100010001001010001000110
00000100000000001100000110000101110001101110000000001000100110001010010010011100010000010100000010010
00010100101101000101000101001000100100000001000101011100000100010001001010000100000000000010100100100
00000000000000100110000100110011111110010000000000001111011110001100101010000100010000100110000001000
00001000110100100011001101000101001110100101011001000010000000010010010011000001000000001000001101001
00001000110100000000000010100011000000001000010000000000010010111110000011110000100100100010001101000
10000000100100100000110010000011010010100000000001010010100011001010010000001000001000011000001000000
00000000000000100000000010010001000010001100001110000100000001001000010010011011000010010000000011100
11001110000010001011000110000000000110000010110011101000000100001110010000110100000000000110011100001
01001011000000001000011010101110010001101101001001101000100000000001010001000000000010001101100000100
01010100010000010000110100000000011000100001000001010100111010001111100001000101000001100001000000010
00010000001000000011010010001000001000000001000000000010000011010110000101000010110000000000001100000
00000100001101001000000000010010000000100000000001101000010101000011001110010011011001000101000100110
10100010001100100000011000010000101010001001110110000010011010001010010010000011000000010001010010010
11100000000001101000000000000000011010110010000000010010110000000010011110001011000101001011001000001
10001010000000001000010001001110010100010111000001011011010000111001001010000100010000011001010000010
00000000010001000001011100010010010100010000110000010100110000010001001000001101100000000010010000000
01101000100000001001000001000100100001001000000100010001000000010100001000111010011001001010100001000
00100010000100011000001010010001001000011010010001000010000000011100111000000110010001100001100100001
00010001011100011001001000100010000000001110010000010001010001000110000110010100000010001000000000000
10101000000010011010001000100100001010000011000100001100000100010000100000001110000000000110000110001
10000000010110000000001000101010011100110111000100001000000001100000010001000100010000101110000001000
00111000100100101001011001000000000000000010000000111101110000000100010000001001000000000100000100011
00010010011100101010110000011001000000011000110011000100000000010000100100100000011100010000011110010
01101000000100110000000100001111010100000000010010000000000000011110000011011000000100000000100010010
11000100110000000000000001110011100000110000101100000000000101010010000001000110000100100000010000111
11000100001000011011100000100110001000111000010111110011010000010000100000100000101000101110100000000
00001000101001100001000010000000110000100000000011010011011100101000000010100001011000010000001000000
10001010011100100110100011010000000001000000000000000000000000000000101010100000001010000100100101001
01010010000000011001111011110001010001001000110101100100000011100110010000000000000001111001000010000
00000000000001001001110110010000111011010001000010010101101100000000101100010010000010111010111100100
00000000101111110000010010000000000000100101000000000000100001000000000101001000000000000000011100110
01000000001100001001100000000110100000010110001000011110000000011001001000010100000100100010100001010
00001000100100010110000000010101101010110001000001001000000100010101111001000010010110001000100000100
00100000101001100010111000001000000000001000100010000100010000010111001101011000000001000000101000000
00100010000100000000000100010100000101100101001001000000100010000100000100100101000001001001100000100
10000010100100000100000100100000000000101100000101001001111000000010000101000001000000010000001000000
01000000000000100101101100000000001100000000100000010010100011011100010010001010000100001001100001010
00101000000000010001011010001000001000000110000100011100010000001001000100000000000100001000000101101
01011101000000001010001000000000001000000001000111000001100000101011111000100110000000010100010100000
00110101001110100100110000011000000001101110111000000110000110000110001101001001100000100010001101100
10010000100100000100001000000101000101000111000000011011100000110001100001101000000100000000000000001
10110001110001010000000010010001001010010000010001100000000110101100001000010100100001100100100011010
00001111001000011110010010001100010000000000000010000100001001010010011000000100011010011011100110100
00000000000010000010000000001010000000010010000000000010000010001000000000110010000000001101001100001
11011100111100001000011100100110101000000000010000001001010000010111100011010010001011000110011010110
01000000000111100110001111001000010000100000101000010000000110000100011110000110000001000110010000001
00110111100000110010000010001101001100000100000000001101110100010010010000000000001000000000101011100
10000010000001000101010101000000010100101000000100100001110000100000010011000000010000000001010001010
00000000001111110010000011001011111001010000010000100010001000100000101000010000010000100010100001000
00000010000101010100101000110100001010100000000010010011011000000000010000001001101000101001101010000
01011000100100000100000110000111101011100100000100000111000000100100000010000011101000010000100100000
00100011001001000000000101000010010000000000010001110000000100110011000011000010001000101101001001010
01100011110001011001000000000100110000010000001101100010100000000100111100011001101000111001001000000
00011100100001100010000010110000000110110000110000101010010010001001010101110101000000000100001010000
01100000011110000000100000010000101010010010000001000000000100011011000001000000000001101110101100100
00000010000000101001101110001100100100000110010100000011101000000110000110000000000001000001010010111
00000001000100100000001110110001000000000010010010010000010101000011011000001101001110100011000000010
11100001010001001100000010010000011100000100000000000000001110010000011110110000000101110001100000100
00001011000100100101101010001111000010000001000010010001001000011000110100000011000000000001100000111
01100000010011000010010001000100100010010100110000001000001010000011000101000001011000001000000000100
10001000001111000101010110000100010010000000010110010000000010011001001101101000100000000000000110010
10001101100000001001000100100000000010110100001000100100000100000010000111100000001010100010000001000
10001000011000010111101011000010100000000001000001100000100010000011000011000100101001001001000000000
00001001110010010010000000010100111001010101010100000111011100101010001110000010010000010101010111110
11000001100010011011101110001100000011110100010010010001000010101000101000101000000010000000000100001
00001001010000000000000100100000010000001001000110000001101000010100000010010010000010100000110001000
01000100111000010110001000010110001000100010001101000000100100100100011100010110001000000000010000001
00000001111010000100000000000000010100000000011001101001000000001000000001110110000001000100011000000
11001110000000001000000001010001000001000111111111010101100000010000000000001011100101000000001010001
00010101001000010101001000111010000011001000001100000001000000010100000011110000110010000101000001001
00010000100010100000000100000000000110011000000110000101000010011111001100100000010000000000000000001
10011000000000000110011110100000100001000110101111010100010110101000000000111001100101101000000010000
00011010000100000000001011000000000000100101011010000100010011100001100011010000101111010010000010110
00110100101000100100000011000001000001000100000001110100011101010011010000000011010110010000000000100
00100000000100000001000100000010001000010100010101000000000010000100001001000100000101001100000001010
10011110010010000110100010000000000100001000000001000000000010000100001101000001010000100101010000000
00011000001011011001111010010101110000110010000000000000000001100001000110101101001001000000110110001
10010110000100100011101110010110000010000000000000000001000001000000000100001101000010000001001000101
11001000000001000000000000001100100110000101111000001000100000001100111101001000100101100011100001010
00001010100010110011000000110110010000000101000000010101001000000101111110000011011000000001110000100
100000010101000110000100000000100100001101101000010000010001010000S1000110100100000100011101100100100
10000110010000101000000100010011000001010111001000001001010001100110101010000000000001001010100001000
11100010011000010010010010001010100011110000100000000000001001001110001010011001001010100000011001100
00011100100101100001001001010001101101000011011000100101010010010100000000000001000011000010100011000
10001000000000100000001100000000001010010010011111000000101110000110000100110010000010001000110001110
01010011000000000000100101001010001101000001110000010000000010100001001000000010010000000100100001000
00101110011000000000010110000110110000000000000110011010000000000010101100100101000010010100011001000
10101010010011000001000000011001000001100100101001001000001001000101000100000111000000010010100101000
00001110100000001001101000100100011001000011100110011010000010001101010000000001010001101000101011001
00010011000000101110100000000010000001000000010000100000001000100000100100100100001000011000101000000
01101000000100100100100000001001010000101110010010011000000100000011000100010000011100000000000000101
000110000000010000G0010000000010000100010011000100000101001010000000000000010001001000001101000010000
01010100000000010001101000000100000000001010101011011101001000111000001000000100011100100100100000010
01010101000001100011001000000001001010100110011100010100110100100101100001000010110001000110000000101
01101011010000000010001100001000100110000100000000001000010000111000011100100110100000101110010000100
00001100110111000000001001000100111100000101000000000000000000001000110000000100110000011000000000100
00000011110000000001101000011101000100100101000000100000000011101000110010000000010010110010001101111
