00000101010001011000001000001000100101000110001000010000110001000110101100000000010000100101001000000
00001010000100101000000010000001000000010000010010000100001001011110100100010000000000000100000100010
11001011010001001110000110000011100011101101100000100010011010000110001001000000000010000000000111110
00000110100000000000010001100011000001001100100110000000100100000011100100000000010001010100000001110
01100001000000000000010001001000000100001000011000000011010001010000001100011001010010011010010110001
00011100111001000100001110100100010010000001101000100101101011010000000011000100000000011010011000000
00010000101101010000101100000110110010001010001110001000110000010000000010011010001010101001000001001
10100101010000010000000101000010100001011001110110010101110010001000101110001001001111101000001010000
10111011000000000000000000110000101100011101000000000000100000100001100101000100010001000010010000100
00010011000000001100000011100100010001010011001000000101001010100011000101100010001010010100000010011
01000001101000101000001000101100100001010010110000100101000000010000100100000100100000100001000010100
10010101010111000011100000000101011100100000000000100001100000000100100000000000100000100001000000000
11000100011100000001111110010001010000110000010000100010000000000000010100100100010010001011000000000
00001001010110001000011000000001111010000101001011010010010000101000000100110000010001000000100000101
01001110001000100000000100110000010110000000010010100001100001011011001100100100000000000011010010001
00100000000010100001010110000100111000000010101000010100000111011000101011010001000010101001100100000
00011000110001100010111000000000011110000000011001100000001001100000000000000101000010000000000100000
01000000000000101000100001000100010000100000001001000011100001000110111000100100000011000010110000000
01000000100000001011000000100000000000000100100000011001010000010001001000110100000010011100100100110
00101110001001100100100000010000000101000100010001101001101001010000110100010010110000000000101011000
10101000110000001011001000100110010100000000000000000100010100000000001011110001000000000001000111010
01000000110110111100000111001001100010000110010001000100000000000100111110000010000110010110001101000
01010110110101100000010010000100000000000101000000010110100010100001010100001010111010000110010010000
10010111001011100010000000000001100011000100110111111011001100000000101100000010101110101000011000100
00000100101100000001000010000001000010000010010101000011100000000000001001010001000000100101111010000
00000000001010111100000110100001100000000000011001000010110101010010010000101100101110110000001001111
00100001011100111111000000010101010110001000100010000000011100010000100001100010011010100000001010101
00000000110000010001000001001111000101011010001110001000100100100001010000000110101100000000010000100
11000010011000000000010000110010011011000010000010101000010100010000000100100000000000101000001100000
00100010000100000100111100100000100011000011010010000000001100000010010100000010100010000000110001110
01010110110100010011111000110001010000001000000000000000100100101100100110001100000101100001101000000
10000110001100000100001100011100000001010100000010001100110010001001110100001111100000000101001101011
00000100100000011000110010101100001001000010001000000001001011000010011000000101010111000000001001000
00001110001100011000000011100101010000010110000001110100010100000101100001000101110110010011110000100
01000101000010000000000110001000000000001001101010010101010000001100001000000100000110010000001000000
01111000000000101001010010000100011101000110001100011010001000101000001000001110011000001010001100000
00010010000100010000100001100000111100101000010100000011000011011000100010001000000110010000100000000
00010000011000110000010000110000110000100000000001010000100000001000011010100110000001000010000000010
00010000010010010001010000000000100100000000001010001010000000101011000100001010000100010101001001110
01011001010000100001001100010000000100000000110110001010000010101110001111000001110000000001101100000
11000100100011110001110010111000000000001110001000100100001100000011010000001000001100001000001100101
00001000010010000101000100011000110100110101001010000010010000001110100001001000000101001101011010010
00000000001100100000101011100011100000010001111100110010000000000010001010100110000100010100111010010
10000010001010000000110000010110100001010010110100010101010011001000000000100000010100010010100011100
10001111100010101000000100000000010100011101101101100010101000010000111000000000100000000100011100101
11110001001000001010000000111001100100100001000110100100000100000011000000110101100010001001011001000
00000001001111000000000000011000000000010110011000100100110100000101011000100000000000100000101000100
10010000000100000010010001000000000001010000100000010000110000100000001000011000100100100110101010110
00100101101001101011101001110010010100001010010001000110100100010001010000000001010001101000010000100
10100100010001011001000001100011110000000001001010000100011001110001010100001000010000000000100010001
00000000000001001100001111110110101100000001101110010010001000001000010001110000011000010000011100010
00101110000000100011001101000010000010101010011110001000011000000111001001111000001001010010001101100
00001000000000000000110100100010000001101000000011100000010010001000001000010010010000111101101000000
00010110000010001000000000110001001000100000010100000010100010000000100100100000110010110000010010000
00000100001100000100001011010000001101001000011000100100000000000100001000011001110010000000000000101
10000101100100000001000000000011000010000011010011100100000000010100100000000101011110001111000000000
00000010010100111110001010010101001110010111011000101000100100010000000011011011011010100000000000010
01101101000110010000100001000100001001110001100000001000101000110000111101000000011011011101100000000
01110001000000010000000101101001100101100100000100100010110010000110100000110000000001000101011000000
00000001000010110000100011100001001000010000100110010001010010100000010010100000100000010001011110000
01100100001100010001010010000111000010001001000001111010010100000011010101011000000101000010000000000
10110000000000110010000010110011000010000000000001000001010110000110101000000010010000001000110000000
10001000100000100100100010000101010000000110001101011000010000010011000001000000000000010100100000001
11000011000001001111111100000100000000010000101001010101010000010111000000000001101001000101000000001
10001000000100000001010010000010100000100001000101100000100001000101000010100100000001000001000010001
00100000000010111011000000100100011110011000100110000100100011010010100100011000100011000111100011000
01001100011000000100100000011000111000000000000100001100100000101111000111111001110110100001000000100
00010110010011011100000000100100001100000101001010000100010011001000001010110001100001010000000001001
01000000000111111010000000000000001010000001011101010000001000000100010010000101110010110001001010001
00000000111100001000110000110000010010010001000100000100100011010010001000011000100001000011100010011
01011001010001000111100001111000100110001000101000100111001001100001010110010001000101101000000001110
11100000000010001100010010001001000101000000110001101100100000000001000000100100000001000010100100100
00001001000010000011100000000110000111000001001111010000011000001000011010110011000110000010000100001
00101110000000100010100001110000100010000000000100110101010001100100000001000001000000101000100100101
10000010101001000010000000001011100010000100010001000010010100001000000111101100100001010100000010001
00000001010010000000100010100010000100010010010011000000000000000100001001110101100001000100100010011
00010000000010100000101000101001000000000000010010100000001011100001001000101001000000000110000010001
00001001001000000011010001001011000000011110000001101000110000000000000011001011000100000101001001100
00101000001001000000110001100000101010010000110010001101000110001001001000001000000110011000100000001
00101100000101010100010000110000100101000101100001011000100000001110000001010001100000000001000000101
00011010100000000111000000000000000011000000001000010000011100000100000101001101000000010000000000100
01110100000001100000000000100001000010001110000100000010001100011001000110100001011001000110000100100
00100000011110100000010001011000001000110100100101001001010011010010110000100100100000011100111110000
00000000001000111011101001110001001010101100000100000010110001101000111001000000100010100010010000110
00000110100110000000000100100100000000001010100001000000100111001000001000000100000101001100010000100
10100000010000001100000000100010010110100101110000010000111000100010000010110000001110001010001100100
00100100010010000010110000010000100010010000100000010000000001000100000000000000000100010110100100001
11111100000010011000100000100000001010000010111000000000000001011000001001001000010000000000001111000
00010100100011000000010111100011110000101000010000111000000001011000001010000000101010100100010010001
000010000010000001001011000G1001000110000101101000100010010111000000100010111101010010000101000011000
11101000100011000110001000000100001010000001011011100010100000000111000001001001010000000000000110010
11100001000000100100000100110000000001100010001111000101000000001110000101011101101100000001000100000
00010100110001001000100001000001010000010100010000001000101000101100000000100110001100000100001010001
00000001001100000010001100100010000000100100S10000010100011000000100000000100110000010001001001010010
10000010011110000100010000110000101010100101000001100000000000011000100110001100110010010100011001011
01101000100110100110001001110101110100111100110000101010001001010010000111110011001001000000100101011
00011110001010111000101111101010100110100100010001100010110000010010000110011011011100100001011000010
00000100101100101000101001010100101010011110010000100010000000010100101000111001000110100001000011101
11011000000101010001001000001000000010000010000000100011001000010101001001001000000000110000000001000
01001000011000001000001001110010100001100001010000000001001001110010100000101101111000000000000100010
00100000100000000000010000010100110010000001000011110110100001100000111000001000100001010010101000000
