10100011101000010101000000100011010001001011011001001000000100000010000011010010000100000001001100010
00101000000001010110001101000100010001001000000010000001001010000010100100010100111111010110001100000
00001000001000100000000001100010011100000100000001001111010010001110010010000101000000001000101000000
10000010000001010001001000100110000010000001011000000000001000001000001101111010110110000010110011000
10010010010001000110000000000010010011100000000010000001011100011001100000000001000000000010000000000
00000000000010010000110000000100110010011111001010011011010010001011110000000100000111000001001010111
00001010101111100010110000000100000101000110001011000110000001000101101011100011010010010011110000000
00000000111000000001000001100000101000001001100100111010010000010101011000000000100000001000110110101
11110001010100010100000000000000100100000000100000000010000101010010000001000110000100100010000000010
00000001010000000001100001100010000100000010111000010000000001100000000001000010000100101001100000000
01011001000000000000000001000000000000000001001000110000000010100000000000011000000100010101010100100
00000100110000010100101000000010000100000000000100101000000000010101110010010001010100000001000001100
11101001000001000000000000100010000000110110000000100001000000000100000010000111100001101100000000001
10000000000000001000001000011100010000100100000001001000100000010100000000101101010011100010001011000
10011000101101000111000001000000000001001111100100010000100001000001000000010000001000001011100100011
00100111010001000000111101011001010000001001011101000000010100000010000001010001110100001000100001100
00101000101010010100000000100100000001001000011010100000100111000000001000001000001000000000110101100
00001100111001100011100000000101100000010001000100011001000100100101001100000000011001100110010001011
10111000010001100000011010001000000011000110000000000010000000010001110100000000010001010001000110110
10010101001000000101011111100100001010110100001111110100010000000010101001000110101000011000010100011
00001000000001010011110010000101010000000101100000110000100000110100101110101100010000111000000100001
00010001000001001100000011000000101000010100000100000001101100001001011000001010000010000000010000001
00110011000000100101001000001110000101010000001010000000000100000100000100100000001111001110110000110
00010010010000110011000000011000000110100110000000000010000010000000101000000111000000000001000000000
10010010001100100000100010110111000000100001001000001000000100000010100001100100010001010011000110101
00110110000110000000001100100110000000100100000000000000000101101010100000010111001000000110111000001
01000100100000000000000100000100010001101000110000010001001000001100100101010011000001011111100001000
10000001111000100011010001110100010010000001000000101000110101001010001001000010001011000100110000010
10001000001001111011000100101010100000111100000000000111100000110000101100000101100000101010100110100
10000000000000000000101000100010110000010000000001100110001010000000001010001000100100000111000111000
00000101011000001000001000001000010000100100101011110001000010010101000000011001100000000001000000001
00000000000101100100011011100110101001000100000100010100001100000001010000000000101010100001000101000
01110110101000001011100000011000010000001100111010100000000001001001010100101000010000001111001000010
00100000001110100100100111010011101000000000000000111011000110001000000100100001100100001010100000000
11111100000001110100010000001000000010001000010000110011000010110010100001000000000100000010000010000
10110001000000000010000110001010100001111101000010010110101100010100000011110000010101100110010100000
01011010011111011000000001000000010110000010000110000000000000011000010100000000001110001110011010010
00100000010001110000100101101111001000000000000000000000000110100100011101100100000001000001010010101
10000000100100101001000100000000101101110110000010100101010001000010011010001100010001001001101000100
01010000110001101001000101000000001110000001000011110110000100101000010010100001000101010101101101000
01001001100010001101000000000000101000000100000001000000010000000000000111000101000100000001000101001
01100000011000100110000000000100100010100001000000000000100010100010000101000100000000110000000001000
00010000010001000010000110100110010010100000110000101000001000000000000000001011001110000010000000000
00111001001000011000001010011000010000100100100000110101100000100001100100000010000100000000000000000
01000001011000000100000000000001000010000000100000111000010000001000000111001001111100000011001000001
00100000001000111101000000011010001100000010000000110000010011001000100000101000011000010001111000000
00000110100000000010001001000010100110000101000011000011000000010000000010000000000010000101100001001
11001010100001011001000100101010000000000100100100001000010101000000110111110000010000001000011111100
01000000100010111000101110001100000000001100110000000000000010001001100100000111011000101010010001000
10000000100010010101111100100000000000001110000100000000101100110000000100010100010000000000001010000
00000001000100010010000001100000110111001000100010110101001101011001100111001110100001010100100000011
10000000011011010000110000001011101001000000000101001000100000000000100000000000000001000000110000000
00001010000000000001000110000000100000000010000010001010100010000100011000100100011001000010001010010
11000000000001010011001000000001110110100000100110000000100000110000100110000001010000001111000100101
00001001000000001001011010000100001110001000100001110000010010100000101000110000001010101011100000110
00000000100000001000101110001000110010000010000000101100000110001100000000110001001010000000010000001
00000000100011100001000110001000000100100000000010101000101100000000110100010100110000101000000110100
00000100011101100100100001001001010000000001010110011010010110100000010000001001000001001001000100110
01001000000010000100010100100001010101000010001010011000101011110110001010100101001101001000011000010
00000000010001111010010011000010101011000010000000011010010000000000100110101100001000010001001000000
00000010000010000011001001010001000100000000000001000100001101111001101010000000000010000000000010000
00001011010010100000001000000110000000010100000000000101000000100000000100000000100000010010100000001
10000011111100010011000001100000011000110100100011000000000100000110000110001100010100001111100110010
00001000000000010000001010010001000001001000000100100001100001001000010000000100111100100100010011010
000000100000101010000100000101000010100010G1010001010000100111000000010000000010000000000010000001111
00001100000000000000110110010000110000101000010001000000110101110000101000011110000000100001000000000
10001000110001001010000000100000110100001100110011000001000010110001010110100001100000111000100010011
00100110100001000011100000100000011100001100000101000101100100101000000111000100011111010001001100000
00110000100001110010100100010000000110001010101000100000100100100000000001001000100110000100100101010
00000010000101001001110001100010100000101010010000001100001101100001000000110010100000100000000001010
01000000000010001000100010000000011001100000000010001101000010010100000100101000000000110011001101100
00000100001001000000011100110000000010000010100000000010110001100001000000001000110010000001010111000
11000110000001011100000100011010001101000110110011100000100100000010100000011110011011011000100000000
11011000001000000010001010001010010111011000000001101000000100010001000010010000010000110000010001000
11011000001000101101010101000100011000110011000110001000101010001000101011100000100000101101001101100
00000001110110011011101000100110001001001100011000000011011101001101100000000101100001010011010000100
00000010001011000000011000101110100010000000000000100000110100000000010110110001100011010010000101100
01000000000000110000010000000101000000000100010000011100101010101000000100011100011100111000111101111
00010000000000000000000001010100001000010000001000000010000000001010011000000010001100100000010001000
00101100010000001010000111100110001110000010000011001010110000000001010100010000100000110101101011001
00110001001011000010010000111100000010010100000000010001000010100011100100111001000100010010001000010
00000000101000100110110110001000101000011001000100101000001010010000001000000001000000101100001000000
00000001100010001010000000000010010000001110010110110001000100010000000000000010100011001010000011100
00000110000111000010000001010000010001011000000001100101000111010010100111001100000000101110110100011
00000011000001000000100100000100001010100000000010000000001000010011101000000001100110000000000000111
01100100000010100000001000000001001001101001000100100000110100110010111000101000000101001001101000000
00100000010001000110000001010001001010011000010001000000010000000000010100000000101010011101010100101
10001000010001000000001000010001000000100000000001000110100110110111000101010010100010001000001000010
0001100010000000110001001000010000010000000110101010000001001000100000010000101001110001010100010000S
00000000000011000001010000011110011010010011001101101001001000101011100000110001100010011001101000000
00100101001000000100000100000000100100100100010001001011010011010000011001000000110101100110000001000
01000000000110001100011100000010100100010001001000000001000010001000000110111001100000000000001100001
11000010011000011100000010001111000100100110100000010010010010100000001100100011010000100101010000100
01100111000000010000100010000000010010101010100001001000000000000100010001000000001100000000000010001
00000000100000000010101000000011011100000001001000011001010110001000000100000011011000010000010110100
11101001010001010011010001111000000010110011100100001001000000010010100100000011100010100000001000000
00010000100000001000000101000101010010110001011000110000010001010000010100100000001010000000100001010
01000100001100000110110000100001100011100101100101000000010011000010000101010010100000100100111010010
01001000000100101110001101001100010000100000000110010101001111001101100101001100110011001101000000001
00111101010010101001000011101000001100111010000110010001011001100101001010000000111010000101000000001
01011011101100000100000110000001010000010000000010010010100110100000000010000010000000100010000101001
