00000101110000000010001000000110101100000000000010000101110101000001011001010000110011101101100001000
00100000000001000110000001001000100111011000001010110011010010101000010010101000100000101001000000010
00000101000000001101100000010101000000000000100000000011100000000100010000110000000010010111000000010
00010101101001011111000010010011100010000000010000000000010100000001100111001100110001100000000001001
00000010001001000101011110100110000001010000000001010000000000010100000101100001101100101110010010001
00000011111010010100000110100010001100000000001101000001101010110100001001000010000000011000101100000
01010000111011010000010000001100110001101000000110001010000100000110000001000011000000010000000000000
00110001111110100000011000000010001100010100110100000001000100011101000000001001100010011000011100001
00000010100001001000000001000010110100000111010010001000110100010010000000001001000100000001000010000
10100100000000111101100000011001000010001100011000010110010000101100000011011000110101001010001010010
00100100000100100000001000100010010010010000010101010000001010001000001000000001000000101000001110100
11111100000001101101000000100000100010101010010000001000001111000011100011000000000001010010001000000
00001100010001100100101000010010011001101000000100100001010000000011100000000100100000001100000010101
01101000111010010100111110110000000000101000100000000000000000010010000110000100001101000010010110010
10000100010001000010011100000000001100100011010100000100011100111000000111001001001001101000000000000
01100001101000000011010000000000001011000100010010010000001100000000110010100100110001101000100100000
00101001000000010000000110000000100000000000000000100000010110101000000000010011001010000010000000000
00000011000000000010001100101010001111000000100000001000000000100000100011000010111100010101001000000
00010000001011001001110000000000010000001101010010000100001000001011011100010100101010000100010010000
00010110010100011011110100001010100000001100111110010110000100111000001000001000110001100000100000100
01000000001101000010100101000101011000001001000110111100000010000000000000110100100000010010000000000
00000000010000010010101000000000100001010100100010100010011000010011100000110000001001000111000000001
10010101000000100000001000011000100000000000010000100000000100000001011000111000000101110000010001100
11011011001000101000011001100000001000000100000010100010001100111000010000010000000000100000100000000
11010010000110000100001011010000100000011000000010100110010001100100100000010010000001010100010011101
00000000000100100000001001010000010000000010110011100110010110100000000001011000000100100010011001000
00010000000011000001000011001000000010001101000000001100000010000000001100000100010000011100000100100
00000011100001001000100100101010000000000010100010000000000100000011000000000001010000001000000101010
01111100010101100001000101000001100100000101001101000000000001010000110000001000100000010100001100000
00101001101101101100100100010100100010010000001100010010010111001101001010101000100001100000000100100
01001001011000101100000000001011000111000000010000100010000010100011100101000101011001001111000000000
00111010100100110010000011001011000001000000000000001100000000000011000110100000010001011000100010000
00011001011001111110000010001000000000010100101001011100000000000100000011101010010010000000000000110
00000000000010000000000110000101000110000000010100100100000000000100010100010010010001001010000000001
000100000101010010000001000000S1001000000010000001010000000000001001010010100100100010011100110100100
10000101100001011000110010000101000101101011000010010000100000000000010001110000001000001011010100010
00101010000000000010000101010000000010000010001000000100010110011110110100001010001100001000000010001
01010000010100001000000000010000010000001000000101101010000110001011010110000000010100000000001000001
00000010101100000011100000100100001000010001100000010000100100100000100001000000101000000000000100010
00000000101000001001000100001000100110100000110100010100000000010000000111100001110101011001101010001
10100000000000101001110111100010110101000010010011001000100110100001110101000101001100011100000000100
10000000000111001000000011001011010010001111000001001100000000110000001001010000100101001000010001010
11010010100001000010001011000011100100110110010010011001001010001110010000100000100100110001110000001
10010010000001001110010001001001001001000000001001001010001100110010000010000000000100111010100100000
00000001100110100011110100010011010100010111100000011000000110001010000001000100010010000010000001010
10100100010000000010000000010000100000000001000000000000000000010110000100000100000001000110000000000
00000100010000000000111000100110010110010100100000000010110001000110100010001000000100000010000000001
00100010111000000001010010000000000110110001000010010010111000001000000100000010000000100000010000100
10101000101100000000101101111000010100000011010101000000100010010010010100010100001100000000111100000
10010110000010000000000011011010000100101001111011000010000010000000011000000001000000010000000001110
00000110001100000100010000000000000000000000101010001100000000000000110100010110010010001001000100010
00011000000000010001001111011101011000001010000000100101000001000101010000000011001001011101101000010
00011001001100001100000000100100001010000010010010011001101001000000100010100101001000010100101100100
11010101111000001010000010001000001010100001100100110000011000010100100100110010100000000000000011100
01000101001010100000110000010010100010000100000000000000000110000100000011000001001000101110001001001
01010000100000101001111100001011000110001000100010000001011000001010101001001101100010010000000110000
0000000110G110011010001000110100000110010111110001010010001010000100000000101010000100110001010111001
00100011000001010000100001000001100011000100010111011010000100100100001000110010011000000001000000000
01101000111100000000101100001000100100000001111001011010101000000000000011110000110011100001000100000
00010100111011010101011000100000010000010010100101000000000111011000010000011000011010100001010000011
11000000001000000010100100000001000011001000100000010000010001100011110001001001000011100000010011010
10111000000000001000101001000100100110011100010101000000010000111100101011001000001000100000010000000
11000100000000000100000110000101101000010010000010001001001101000001001000000000100000010000111010110
00010000000001101010010000100001111000001000000000100100110000011000100000000001000000010101010100000
00101000010011010110100000000000100000001000011000000011000000000100001000101000000101001010001101000
00001001010100010000110010000100011010000001000010010110000010100000001000000000100110000001001011100
10100011000000011000110001001000100111000110001101000001001001100010000111000001011101010100000110000
01010101000111000000000000101010101010010100001100001101100000000011100000000010100110010000110101110
00101101011100001101000000011000000000110000101000010010101010101000010000010001000100001001100010000
00000101010010100011001000000000001000010001100100000010000100010011011000110001000010000010000011110
00101001111001110000010111000000000011001000000100010110000001000100101010000101010000001000000011000
10000001010000001001000010001010001011100000100110111001010100010110011000000100101001100000111111111
00001010010010000000000000001001000000000110000001011101000110010110000000000111000010001000000000001
01001000001001100000000011010110000101001000100010001000100000000001000100001000001010001100100100000
00100000010100100001011010100100000000000100001000001010110001000010010011100000010000100101100001000
00010001100000001011100001000101011010100000000010000110011000010000010010101000000000000001001000111
11001000000111001000000000000000001010100000000010000110100101101001101000100000010101100010000010101
10011010000000000100010111010101010010101010000000000000100000001101011000110100000010000000000001000
10000000001101001001100011000110001010101000101000100100001010000000100001110100000010100010000010100
10000011001101010000100000001101110000000001010000000000000000000000000001000000010100100000001000010
10100111011001000000010001011001101110001110000000001010011100100011001011000010001000001001000000100
00100001000001011000000101100011000000010010000101000000010001011011010000010001000000001011000011000
10000010001111001010000100000110110110100000000100010010001001100001000100100010100100010000000010000
01110100000010010001000010001010011010000111110100010000110000000001010000000001100001000110000110110
10110011100010001101000001000100001001100000100010000100010111000101110010010010110110000110100110001
00100100111000010100110100000000001000001110110010000001101110011010110010011000000100000001000010000
00000011000000110101100000000010101110101100010011010010001101001000000000001000100000001001100000100
00000011110000101100100000001000000000010010000101010011011000000001001110100000111100001101000000000
00100010000100110001100011000000000000000000100010010000010001010010010000000001010000100000100100001
00110000110000000110000010010100001001100010000101010011111001011001000110000000100101100100010010011
01100010000000001010010010110100000000010100100000001011101100000000010001000000111000010000000000100
00000000010000111000100001000000000011000010110000000001101101010010110000100000001110100001010000101
00011110010000001000000000011001001000010000001110100000000100010010011010001101000000000000000011110
00000011001010000000000001010011000101010000100011001000111001001010000000000001010000010000100000001
00000100100001101110010000000000000010000100100101001000000110100001001001101101100000010000110010011
00100001001000010001100000010000110000001100001000101000100010000100100010000101010011000000100000010
00011100101011000110001110011011000100001100000100010100000000001010101000000000000001000101001010000
00000001100010000100000000000100000000000000100001011010100011000000010001100100000100101000110010001
00110000101101001011001100000010000011010111100010000100000110000000001111010111110010001010000000000
00010001001000000100000001010110001011000011000000010011000001001000000001001000101100010110100010010
10001001001000001000100010100010010100100001010010001000011110110000000011000100000000010110010001111
