01010100000101001100000111010010111000010000001010110100001110010000100000001001010100101111100010010
00000111011011000000000000000000000001000010111101100110000110000010001100010010100000100000010010011
01101001000011110101001100101110010101001110001000001000000000001110000111010000000000101000000110001
01001010010001011010000000000000000100001101100001111010100000001000000010001001001000000000000000001
01000000000110000001011001010111010100000000000000100110011010001100010100000100010010000001100100100
00011011101001010100000111100000001001110100001100100011000000000000001010000100111000000010100110101
00000001101000000100100100000000111010000100000001110000000001000110000011000010001000000101000011001
01100100000100010100000010001010001101011000110101100100100011110011010000011001001000100000010000000
00001001010100011100001001010101010000110000010000000110011001000000010000111001011010101011001010000
01011001001010111011000110000100010101110110001111000110110010110110000111001101011010001010011000000
11000111010001000100110100000000011101010011000001100001010100001001010000000101110000110000100001001
00010000000100000100001100000100001111001000001000000001000000001111000000000001010011001010001000100
01010010000011100100000011000011101000101000000100011111001100010000000100011100101010110000001110000
00101001000011110000001010101000000100100000100000010100000001011010000100010000000000110010001000100
00000000101001101001011110000010110010000100110110010010000010111000011001100001000010101011010100100
10010100000101000010101000100010000100000000001110000011000000100111010000110000000001011000000100000
00001101110000100100000010100010000101110000100010001110000100000000000010000000100000100001010010010
10101100000000100000010010000010000110010000000110000010000000010011100101010010100011100000100010001
00000110100101001110000000100001110000000000010001001001110000010001100000110000100000101000001000000
00010001000101111000010000110000000110110000101011000001100001100000100110000000000110010101000100000
10000001001011000010111110001110000100101010000010001000000100000110100000000000000010100001000111000
10000010011100001010101100000100000000101001001010000010000110100011000000100100000011000100101010100
01000110000000001000110010010000110010100000101110111000001100010000001001100010000101001000000011011
01000100100000000110000001010000011100000010110101000101000100111010100000100100100000010100000001011
01001101000001001000000000000000000011000100011000000110100000101110000100110110000001000100000001100
01010000100100010010110000000010000000110010001110000000010000000100000100001100010010110000001001101
00100111100001010001000010000000000000010000100000011001000010101100100000000000111000100111001000000
10001100001010000100110000010001001100010001000011110000010101001100001101000000000000110100100000110
01000000000000100101000100000011101010001101100101010001010010010011000010100001000010111001011000101
10001000000001011110010000000100011110000100011010101100010000100000001000011110000100000010010000101
00000010010000000100100101001110001001001000000000000000010000100010000001100100000000110000001001100
01000001000000000001000110000000000000000110000100000000101000000000000100001010001001010001010001000
00000111100001110010000000010100001010000100010000000101010000000010000101000000001000100011110110001
00011001000000000100101011000010000000000000010100100111010001100010000110010001000000001000000010000
10010110001000000011110010000000001100001001010101010010000101010010000010100010010101000100000000010
00010000000100000100100000000001000010011001010000000100000010110100111001100100001010011010100000000
01011000000100000000100000110000010000011000110110000100100100000001011110011000000001000010000100000
01011000000011000000011100100000000001010000011010101000000001100010100101100100001101001001000100010
10010001011000010001000001100010000000000001001100001101001000000000010000000110100000000100001000000
000110000100000000010000000010010101010000000101010101101101101G1000001000000110000000100001000010000
00000000000000101101010101110100000010011000010100001001100000100000000000100000101100010000000100010
00101001000010100000100101001100100100110111010000000110000010000011000110000000000001010101010101110
11111000111000111001010010001000000000010000001010101000100001000101000000000011001000110100101000010
00100001100011001111000110010100110100001000001010001101110010000001000001100000100001010101000010000
00010001000001001010100011110100010000000000000010101000001000000000000100010010000000010010001100100
10111000000001001011100010010110001110000110100000100110000000011101000000000000100001001000100000000
00000010000000000101000011010000000011111010000010000000000101110010001111100000001000110101011000000
00000001000100000000011010000000111000000001010001100100100001000000010000011111000000101100110100011
10010001110000000011101000001100011000011000100110100100010010001100000000000000000000000000100000100
10111100000110000010000111000001000000110011000000011001000110000000000000000000011000100001001101010
11001011000000000000110010100000000000010001100000100100001000001010010000011100000010001100000111101
01001101010011000000001100000101011000000010000100100011110110110011100010000111110100000001000101101
10100110010001011101001001101100111000100010011101001100000000101100001100010010000011000000011000000
00010000000000000000110000000000011000000011101101010000111000001010011001000001010010000000100010010
10011101000101011100001000100100100000000000000100010000110100010010100100100001011100100100000000001
10111010010100000100011000000001000100000100001010000000011010010000010101011010000010110000010000000
00001001000010000010000000001100001001000010000000011110000111000000100000100000000011000111000000000
00100010100100101000000100000100010100000101110000000010111101010100010000001000010001100011100101011
00000000010001000011100000100111000010101011011000100010000010000001010010100001000000000001000001001
01100100100000010000101010110100000000001000100100000010010001110101010001000100101010000001010001010
00000100000001001100100100000000000010001101000000011100000100100110000100000000000100000010001000011
00010100110001010100001111101100000100000001001000100110100000010001000100000010100111000100111011000
00100000000110100110110100011001010100000110011111000010110000000000100010010101010110000101100110011
00000001101010000000010010001000110101010000000110010101000100000001000000000000000100000001010110000
00110000100100100101000110100100001010010100011001001010001000100000000000100001110000010101101000100
10000001010110001110001011011011000011010010100001101011000000000000001000010001010000000010100001001
00101011111000000011000001000101011000110000111011001000001110000010011000000001000000000010111110101
00010101000000000001001010001010010101000000100100000011001110000001000000001101001010010000111001000
00010001100010001000010000001000000111010000010000000000000000011010111000100100011000111010100100001
01101001000100010001010000000000101110000010001000111111100001001101010100011001101000001000011100001
10000100101001111011000100100000000111000010100001000000010010000010110000001000000101100000010000000
00100001000100000010101110111000000000000000000000000100010010100100001000010000000000101110001000100
10100001000000100000101110100000000101000001011000000000111000100000001000000100000110000010000001000
00000010000011100000000000010000001000000000001000101001000000001000100000100000000101001000101100010
00000100000100110100100001000010010000010100010110001110001001000001101000010001001110001010001001101
10000111001000000000100010000100110011001010000000011000101010000000000010000000011001000100000110100
01000001100001101000000101111000111100011011101100010101011000110001100010000000000000101100101000000
00011010010010000001100000000001000100000100001000100100000110000001000000000101000001000001100011001
01011000000001010000000000000000010000000101001111110100001000000010001001100000000100110001100000001
10000100101110010010010000010011000100100001100001100000100010100010010001100100000010001000001000000
00000110100110000011000100100000000100100101001111001100100100000001010010001001000010001001000000110
01000011000000000001000000000100000000000100000101001000101010000010001000110010000100000000010000100
00000101000000010001101110000000000110000111001011110000000100110101010001101000000011000010110000010
00110100010000001000100110010110110001110000101000101000100000001000000010001011100001011001001001011
00000000010000100100000010000000000001010010010000000110000000001100010011001000110010100010100010001
00000110010001000000010000000010100010000000000101010100110100001000010010100100001000010001110111011
00000101000110100011100100100000000001010001101111000000100001001000100000000011011010101101011010000
10000000011100100000000000001000000000100001000011000010000000000100101001001110000000000110100001101
0100010001010000011100000111001010010000001100000001100000010S010000000011010000000001011100000100010
01000001110011100000010101001000010000000000000000011001000000110000011010100000000010100010000000000
00011000110010001001000010010111000001000111000000000010010100110000010101100000000000111111101110001
00010000000100101100101010010000010001000100000110000000100100010000001101010100100110101101000100010
10100011001000100100010100000010011000000100100001011010100000010000001000010000100011000000111100000
10000000000101101100010000010000000000000000101000010001001001000001110100000000010100000101111111000
00000000011000000100010000001000001110000101011011000101110101110000000011101100000010000010110011111
00010101101001000000000100000000000001000000101000100001001100000001000011101100110110010010000000000
10010000010000000010000000111001110010110110000000011100100010110001010000000010111100000001000010010
00001011010001000101100001001110010111100010000100000000101100100100001001000101010011100001001100001
01000000000011000000001010101010000001010000000011000101001000011100000001010000100100000000000100010
00010001000001010000010000101101111110001011000001010000000000110001011100001101010010000000001100010
00001000010000011001000000000100011010100101001000000000100000000101001000101001010000011000010100101
