10001101000000100000010001110000110000000000001010100000011100000000100001000100000001100001101000001
00110010001100000101100100011001000010000100000110010010101111000001100010001001101100000010110100001
00010000101001011000000000010110100101001010100000010000010100111101001100011110000011100100000110111
01000000101010100101000001000100110000100100100110110000000101100101000010000010000010000001000000010
10010000010100000000011101010000010010000100000000101010000100001000000011001100000001010101101001001
01000000100010001001101001111100000010000001010000100000011010010101000010000011100000000000001000100
00000100000010001000010100100000001100011100101000000110000010101001101100000000000000001001001001101
11000001010000000000101000001001000000010001010010001011001100000001101010000000011100000000101001000
00010001010100100001010000101101001100010100010000000100000000001001000111010000010001000100100100001
11000010010001001001001100001000001001110100100010100000100000000010000100010000110011101000001000001
10000110000000111000100011011000001001000010000000000001111010000000010001000001100010011100000001101
00000001101101000111011001000100000100101001000010001011001000000000000000110010000000000000110000100
01100010000110001100000100010010000110000011000001001000100010111010000000101010111000000000010001000
00000001000100001110000100000001100110010101111000100010000000100011100000000100000001001110100100001
01001000100000000000011101000010010110000100000111000001001000100000000000001001000110011101000100010
00000110000001010010000010000100000100000100011101011110010100010000000110011101000000110001000000000
10100000101000000000100010100110110010000101010010011101000010000011100100000010000000001001110010000
00011000100001010001000000000010110100000100010000010110010000000000000111000000001110001100110001110
00000101000000000001010000111001100000000001100000000000000100010001101000000000110010000000000101111
00010100001000000111010100000110001100010100011010000001110100101010000100011000010001000000011100000
00000100001100000101000010000000110000000110010010000000000000000000111000010011000000010011011110011
10001011000000101100000010000100000000000010100100011000010000000100010010001011100011010000000001000
10010000010100000000001000010000100000010110001001000100011000100011001000001000001001000000101100100
00000111110000010010000010001011100010011000000011101100001010100010000000010111010001000111101110000
00000000010000000110000110010010000011000011100000000010101001001001000000000000000001010010000010000
00010000101000000000000010110000000000010000110001100000010000010000000000000101000000010110000100010
00000000000101010000100001000110000011101010000000000000001111010101101101100000101010100010100000000
00000010000101010000100000100101010100100001110000110100010000000001100010100001011000011000000100110
00010001000000001101000010011100010000000001000110000010000000100011000110000110001000000110111001001
00000101101001000000000000101001010101000100110110100011011000000110010000110001011010101000000100010
00000001111000100001000100011011100000010001101100101110001000011001000001001000000001000010001111001
01001000011001000000001000001001100010100000000000001010000100101000010101000010000000000010000011010
10010010001001000100010001000101101001000100001100000000000011100000100010001101001010100110001100001
10010111101000000111010100000100010000001010011110100000100001100011100000001000100100100111010110000
11000010000000000000100001100000010100000100000000001000000010010001000111000000011000000000000100000
11000010010101010100011100000101001101010000010011100001100000000000010010001010011011000111011000000
01100000010101100100100000100010000000110000000000000010001011010001011001001000010000010000110000000
10100100011000110011001000111100000001000000100000000110011100000101100010000000001011110000001000011
01011001011110100001001000100000000110000000010001011000011100010001100010000100011010100011110000001
00010110000011000000000000000101000100110100000010101000010100000010000011000110000000000010000001000
00000000110000000010110000000001010100101000000001100000000100000000000010000110000001000000000000011
01100000010110000011100100100000000010001011100001010000000001100100100101010100010000000010000000000
01001000000100100000011010000000010011000110010100000001110100001000010000000100000011000000100000010
10000000011000101101000000101000010000010000100001000000010000100000101000100000011110001110011000000
00100001001010000011000111000011101000000111100111001000110110011100000000111011100101000100000001110
00000001001001010110001111001000000010110001100010000001000000011000010100100100001010101010110000100
01000000011100001000000000100110001011000000000001001001000110101111100001011010001110010001000011100
10000111101000001111000000110000000000101000001001100100010100000010010000110000000100100000101001010
00101010010000100001000101010000000000111100010001111000100010011000100000010001100011100101001000101
11001000010000100000011110000110000000000101000100010000000010001000000000100001100011010100011101000
10001010001000000000001100010010001110011000001110010001000110011001000001000010011010110000000000100
10000001010000110001010001010100000001010000000001011000000011000001011000111000100000001010001001000
01101000011100001101011001010000010100010000001111010001001000000101001100000000011101000100000000000
01011000100011000000001010000100100000101011110010101010100000001011000001000001000111000000110101000
01100000100000000000001001100001000100000010000000001110001000000101000000001010000010000010000110000
01010101011100001010000000010000000000001000010011000010001000111000011100001000000000000001100100110
11111100000010101000000000110010000000001000010100001011010001001000000000010000010100000000010000000
00001111110001111001010000000000001000001101000101110100010000001000011001011000000100000011000011100
01100110110001001101000000000000001101100000001100001001000110100000001000000101000001010101010000101
01000011001101010101010100110011000011101110001101000000101010000101100111000000101100000100001110111
00101000001001010110100110000110000110011010011110010010011000011000110000101110000010010000000000010
01110000000100000000000011100010000010001101001011001100000000000000010110001001101000000000010000010
00111000000000000000010100100000110010100000100000000001001000000010100100000001100000001100001000001
10001000010001000001010100100000011100000000000000010011110000000100000011000000000000010010000000001
00111001100010101100000000000101010110001000001001100100000011110100100001100001100100001100000001101
10000111010100001111010001110101000000000101100100000101000000111100101110000000101011000000100101111
00100011000000111011000101000001000000000100101000011000110110011010000100011000000000100000000001001
10000010100001010000S00100000000010010100000011000010000010100100000000100111001000001001001000000001
00000000000100100100001011010010000100001010011010000100000001100010001100000100001011100000010110000
11100100001001110100111011010000100010000111110000100001000000011000100000000010101010010000010010110
11000000100010100000000100000100110000101000100001010111101010000001001000000011001010100000100000001
10110000011010000010000000110000000010100001100010000000000010000100010000011000000010110010001101100
01001000100000011010011101011000001001000001000G00001000101001100000100110000000010010001010001000100
00001000000010110110001001000000100000010110001110011000110010010000001011000100101010010100101100110
00011011001001110010000010100011000110010010000000010010001001001001000110001111101110010011000001001
00010000101100010010100001110110000100010000011000100010001110111010000000000001000000001010000001001
00000000000001100000000000101100011100100110000110010000100000000011010000101100100000110001001001000
00010000000000111000000000001000010011001011100010111110001000101000101010000000100000000000000001000
00010000100000111101110001110100100000111011100000101000100000000000100010011110000011010000000100000
00000010000000001100000000001000100001011110000000101000111101110000000000000101000010000000101001100
00011000101001000000001000000111000010010010001110100100000000011110010000000101000100010000111100010
01100000101000000100101100000000000010001001000000100010001011010010001010110000000000110110110000010
01011000001101000010000100001000101000100000000101000001001101010000011010001000110001100011000001000
10001100010100000000100011110001000001010001000000000000000100001000000100110010001010100010101000100
00000011001111010100000001000000000001000010010000000110110011001100100110010010010000100011000100010
01000001001100101010000000000000001001000010101100000110000101010100000000110001000110110000000000100
00000100110001000101111110000010100000001000001010100000000010100001011000100011011001000000101000001
00000101001010000011000010010010000111101011100111000001001000010000100111010000010011000000000001011
01000000010000000000100101100000010010000001010000100100010100001000010000010000000000100100100100001
01000001000001110000111010100000010001000000100001001110000101000010010001100100111010000000010000001
00000000110000110000010100110010000101000011001110101001010000010100001010000000010001000000100000001
00000000100010010000010100100100000100010000000010000000001100100000001111000000011101010000000100000
10100000011101001100010100100000100010000000000000000000001010100111111000001000000000001000000000100
00000100000001110011000100011110001001110000001000010010000100110010010000110000000001010001011001101
01010001110010000011000110001010000000100010000010001001110000000100010000100100010010001010100100101
00100000001111100001010101000010000000000010010010001001000010010101100000001000110101101110100001000
11000001000101111100010001000011000000011100100001010010000010011110000000010000100100011100001100100
00000100010010110010001011010100100000001011000001001000100000001000000001100010001100000000010010000
00001110000001101010010010001100010101000000010000100011110110000010000000100001000000000001010000111
10001101100100010100010100010000101010000001000010100001101010100000001100000010000101100001010000001
00100001000001010100000101001001010111000010001000000110000000000100101010010001010000000000010000110
